file,line,size,real-size,type,subtype,name,heap?,id,total free,hex address,sum_alloc,actual_sum_alloc
tag_files\string_ids.cpp,147,4186112,4186196,,,,h,2,536870912,0000000020128040,4186112,4186196
tag_files\string_ids.cpp,150,26163200,26163284,,,,h,3,536870912,000000002053F040,30349312,30349480
tag_files\tag_groups.cpp,5852,32,116,bs codes,short_block,,h,6,536870912,0000000000FDA830,30349344,30349596
tag_files\tag_groups.cpp,5852,64,148,bs codes,mapping_function,,h,7,536870912,000000001B91E030,30349408,30349744
tag_files\tag_groups.cpp,5852,32,116,bs codes,byte_block,,h,8,536870912,0000000000FD9CB0,30349440,30349860
tag_files\tag_groups.cpp,5852,48,132,bs codes,function_definition_fields_v2,,h,9,536870912,000000001B913310,30349488,30349992
tag_files\tag_groups.cpp,5852,32,116,bs codes,real_block,,h,10,536870912,0000000000FDA230,30349520,30350108
tag_files\tag_groups.cpp,5852,112,196,bs codes,function_definition_fields_v1,,h,11,536870912,0000000000F944E0,30349632,30350304
tag_files\tag_groups.cpp,5852,72,156,bs codes,render_method_animated_parameter_block,,h,12,536870912,000000001B8F0A60,30349704,30350460
tag_files\tag_groups.cpp,5852,176,260,bs codes,render_method_parameter_block,,h,13,536870912,000000001B9017E0,30349880,30350720
tag_files\tag_groups.cpp,5852,32,116,bs codes,tag_block_index_struct,,h,14,536870912,0000000000FDA8B0,30349912,30350836
tag_files\tag_groups.cpp,5852,136,220,bs codes,render_method_postprocess_texture_block,,h,15,536870912,000000001B9004B0,30350048,30351056
tag_files\tag_groups.cpp,5852,56,140,bs codes,real_vector4d_block,,h,16,536870912,000000001B91E2B0,30350104,30351196
tag_files\tag_groups.cpp,5852,32,116,bs codes,int_block,,h,17,536870912,0000000000FDA6B0,30350136,30351312
tag_files\tag_groups.cpp,5852,40,124,bs codes,tag_block_index_block,,h,18,536870912,000000001B9133A0,30350176,30351436
tag_files\tag_groups.cpp,5852,48,132,bs codes,render_method_postprocess_pass_block,,h,19,536870912,000000001B914870,30350224,30351568
tag_files\tag_groups.cpp,5852,48,132,bs codes,render_method_routing_info_block,,h,20,536870912,000000001B913160,30350272,30351700
tag_files\tag_groups.cpp,5852,32,116,bs codes,runtime_queryable_properties,,h,21,536870912,0000000000FD9B30,30350304,30351816
tag_files\tag_groups.cpp,5852,64,148,bs codes,constant_buffer_descriptor_struct,,h,22,536870912,000000001B91CF50,30350368,30351964
tag_files\tag_groups.cpp,5852,48,132,bs codes,constant_buffers_block,,h,23,536870912,000000001B9142D0,30350416,30352096
tag_files\tag_groups.cpp,5852,40,124,bs codes,constant_buffer_indices_block,,h,24,536870912,000000001B9143F0,30350456,30352220
tag_files\tag_groups.cpp,5852,72,156,bs codes,constant_buffer_resource_definition_struct,,h,25,536870912,000000001B8F0380,30350528,30352376
tag_files\tag_groups.cpp,5852,312,396,bs codes,render_method_postprocess_block,,h,26,536870912,000000001B93A0C0,30350840,30352772
tag_files\tag_groups.cpp,5852,168,252,bs codes,render_method_struct_definition,,h,27,536870912,000000001B9026C0,30351008,30353024
tag_files\tag_groups.cpp,5852,40,124,bs codes,shader_contrail_struct_definition,,h,28,536870912,000000001B9130D0,30351048,30353148
tag_files\tag_groups.cpp,5852,168,252,bs codes,shader_contrail_struct_definition,,h,29,536870912,000000001B9027D0,30351216,30353400
tag_files\tag_groups.cpp,5852,40,124,bs codes,shader_particle_struct_definition,,h,30,536870912,000000001B913D30,30351256,30353524
tag_files\tag_groups.cpp,5852,168,252,bs codes,shader_particle_struct_definition,,h,31,536870912,000000001B901A00,30351424,30353776
tag_files\tag_groups.cpp,5852,64,148,bs codes,sound_resource_definition_struct,,h,32,536870912,000000001B91D770,30351488,30353924
tag_files\tag_groups.cpp,5852,152,236,bs codes,cache_file_sound_struct_definition,,h,33,536870912,000000001B93A260,30351640,30354160
tag_files\tag_groups.cpp,5852,56,140,bs codes,scenario_resource_layer_identifier_struct,,h,34,536870912,000000001B91E990,30351696,30354300
tag_files\tag_groups.cpp,5852,48,132,bs codes,scenario_object_names_block,,h,35,536870912,000000001B913A60,30351744,30354432
tag_files\tag_groups.cpp,5852,64,148,bs codes,dont_use_me_scenario_environment_object_block,,h,36,536870912,000000001B91E350,30351808,30354580
tag_files\tag_groups.cpp,5852,256,340,bs codes,scenario_structure_bsp_reference_block,,h,37,536870912,000000001B93A360,30352064,30354920
tag_files\tag_groups.cpp,5852,56,140,bs codes,scenario_scenery_palette_block,,h,38,536870912,000000001B91E8F0,30352120,30355060
tag_files\tag_groups.cpp,5852,32,116,bs codes,scenario_object_node_orientations_bit_vector_block,,h,39,536870912,0000000000FD9FB0,30352152,30355176
tag_files\tag_groups.cpp,5852,32,116,bs codes,scenario_object_node_orientations_orientations_block,,h,40,536870912,0000000000FD9D30,30352184,30355292
tag_files\tag_groups.cpp,5852,88,172,bs codes,scenario_object_node_orientations_block,,h,41,536870912,000000001B9237F0,30352272,30355464
tag_files\tag_groups.cpp,5852,56,140,bs codes,scenario_object_id_struct,,h,42,536870912,000000001B91E490,30352328,30355604
tag_files\tag_groups.cpp,5852,56,140,bs codes,scenario_object_parent_struct,,h,43,536870912,000000001B91D3B0,30352384,30355744
tag_files\tag_groups.cpp,5852,208,292,bs codes,scenario_object_datum_struct,,h,44,536870912,000000001B8FAFD0,30352592,30356036
tag_files\tag_groups.cpp,5852,208,292,bs codes,g_new_scenario_object_datum_fields,,h,45,536870912,000000001B8FB230,30352800,30356328
tag_files\tag_groups.cpp,5852,72,156,bs codes,scenario_object_permutation_struct,,h,46,536870912,000000001B8F0C70,30352872,30356484
tag_files\tag_groups.cpp,5852,40,124,bs codes,pathfinding_object_index_list_block,,h,47,536870912,000000001B913550,30352912,30356608
tag_files\tag_groups.cpp,5852,80,164,bs codes,scenario_scenery_datum_struct_v4,,h,48,536870912,000000001B8F0E80,30352992,30356772
tag_files\tag_groups.cpp,5852,184,268,bs codes,scenario_multiplayer_object_struct,,h,49,536870912,000000001B934880,30353176,30357040
tag_files\tag_groups.cpp,5852,104,188,bs codes,scenario_scenery_block,,h,50,536870912,000000001B93B4D0,30353280,30357228
tag_files\tag_groups.cpp,5852,64,148,bs codes,scenario_scenery_datum_struct_v3,,h,51,536870912,000000001B91D810,30353344,30357376
tag_files\tag_groups.cpp,5852,88,172,bs codes,scenario_scenery_fields_v3,,h,52,536870912,000000001B9226B0,30353432,30357548
tag_files\tag_groups.cpp,5852,88,172,bs codes,scenario_scenery_fields_v3,,h,53,536870912,000000001B921FF0,30353520,30357720
tag_files\tag_groups.cpp,5852,64,148,bs codes,scenario_scenery_datum_struct_v2,,h,54,536870912,000000001B91E7B0,30353584,30357868
tag_files\tag_groups.cpp,5852,88,172,bs codes,scenario_scenery_fields_v2,,h,55,536870912,000000001B922D70,30353672,30358040
tag_files\tag_groups.cpp,5852,176,260,bs codes,scenario_scenery_fields_v1,,h,56,536870912,000000001B900F60,30353848,30358300
tag_files\tag_groups.cpp,5852,56,140,bs codes,scenario_crate_palette_block,,h,57,536870912,000000001B91CFF0,30353904,30358440
tag_files\tag_groups.cpp,5852,64,148,bs codes,scenario_crate_datum_struct,,h,58,536870912,000000001B91CC30,30353968,30358588
tag_files\tag_groups.cpp,5852,104,188,bs codes,scenario_crate_block,,h,59,536870912,000000001B93B5A0,30354072,30358776
tag_files\tag_groups.cpp,5852,40,124,bs codes,g_scenario_editor_folder_block,,h,60,536870912,000000001B9146C0,30354112,30358900
tag_files\tag_groups.cpp,5852,248,332,bs codes,scenario_scenery_resource_struct_definition,,h,61,536870912,000000001B93B670,30354360,30359232
tag_files\tag_groups.cpp,5852,56,140,bs codes,scenario_weapon_palette_block,,h,62,536870912,000000001B91CB90,30354416,30359372
tag_files\tag_groups.cpp,5852,48,132,bs codes,scenario_weapon_datum_struct,,h,63,536870912,000000001B9131F0,30354464,30359504
tag_files\tag_groups.cpp,5852,104,188,bs codes,scenario_weapon_block,,h,64,536870912,000000001B93B7D0,30354568,30359692
tag_files\tag_groups.cpp,5852,104,188,bs codes,scenario_weapon_fields_v2,,h,65,536870912,000000001B93B8A0,30354672,30359880
tag_files\tag_groups.cpp,5852,176,260,bs codes,scenario_weapon_fields_v1,,h,66,536870912,000000001B9028E0,30354848,30360140
tag_files\tag_groups.cpp,5852,192,276,bs codes,scenario_weapons_resource_struct_definition,,h,67,536870912,000000001B935720,30355040,30360416
tag_files\tag_groups.cpp,5852,56,140,bs codes,scenario_vehicle_palette_block,,h,68,536870912,000000001B91D090,30355096,30360556
tag_files\tag_groups.cpp,5852,40,124,bs codes,scenario_unit_struct,,h,69,536870912,000000001B914480,30355136,30360680
tag_files\tag_groups.cpp,5852,104,188,bs codes,scenario_vehicle_block,,h,70,536870912,000000001B93B970,30355240,30360868
tag_files\tag_groups.cpp,5852,104,188,bs codes,scenario_vehicle_fields_v2,,h,71,536870912,000000001B93BA40,30355344,30361056
tag_files\tag_groups.cpp,5852,48,132,bs codes,old_scenario_unit_struct,,h,72,536870912,000000001B913430,30355392,30361188
tag_files\tag_groups.cpp,5852,160,244,bs codes,scenario_vehicle_fields_v1,,h,73,536870912,000000001B93BB10,30355552,30361432
tag_files\tag_groups.cpp,5852,192,276,bs codes,scenario_vehicles_resource_struct_definition,,h,74,536870912,000000001B935F00,30355744,30361708
tag_files\tag_groups.cpp,5852,56,140,bs codes,scenario_effect_scenery_palette_block,,h,75,536870912,000000001B91CCD0,30355800,30361848
tag_files\tag_groups.cpp,5852,24,108,bs codes,scenario_effect_scenery_datum_struct,,h,76,536870912,0000000000FDA730,30355824,30361956
tag_files\tag_groups.cpp,5852,72,156,bs codes,scenario_effect_scenery_block,,h,77,536870912,000000001B8F0FE0,30355896,30362112
tag_files\tag_groups.cpp,5852,192,276,bs codes,scenario_effect_scenery_resource_struct_definition,,h,78,536870912,000000001B936140,30356088,30362388
tag_files\tag_groups.cpp,5852,56,140,bs codes,scenario_light_palette_block,,h,79,536870912,000000001B91DB30,30356144,30362528
tag_files\tag_groups.cpp,5852,48,132,bs codes,scenario_device_struct,,h,80,536870912,000000001B913670,30356192,30362660
tag_files\tag_groups.cpp,5852,136,220,bs codes,scenario_light_struct,,h,81,536870912,000000001B9005A0,30356328,30362880
tag_files\tag_groups.cpp,5852,88,172,bs codes,scenario_light_block,,h,82,536870912,000000001B922BF0,30356416,30363052
tag_files\tag_groups.cpp,5852,88,172,bs codes,scenario_light_fields_v2,,h,83,536870912,000000001B9222F0,30356504,30363224
tag_files\tag_groups.cpp,5852,248,332,bs codes,scenario_light_fields_v1,,h,84,536870912,000000001B93BC10,30356752,30363556
tag_files\tag_groups.cpp,5852,192,276,bs codes,scenario_lights_resource_struct_definition,,h,85,536870912,000000001B936020,30356944,30363832
tag_files\tag_groups.cpp,5852,56,140,bs codes,scenario_biped_palette_block,,h,86,536870912,000000001B91DC70,30357000,30363972
tag_files\tag_groups.cpp,5852,88,172,bs codes,scenario_biped_block,,h,87,536870912,000000001B922FB0,30357088,30364144
tag_files\tag_groups.cpp,5852,88,172,bs codes,scenario_biped_fields_v2,,h,88,536870912,000000001B922230,30357176,30364316
tag_files\tag_groups.cpp,5852,160,244,bs codes,scenario_biped_fields_v1,,h,89,536870912,000000001B93BD70,30357336,30364560
tag_files\tag_groups.cpp,5852,192,276,bs codes,scenario_bipeds_resource_struct_definition,,h,90,536870912,000000001B936260,30357528,30364836
tag_files\tag_groups.cpp,5852,56,140,bs codes,scenario_equipment_palette_block,,h,91,536870912,000000001B91E670,30357584,30364976
tag_files\tag_groups.cpp,5852,32,116,bs codes,scenario_equipment_datum_struct,,h,92,536870912,0000000000FDA7B0,30357616,30365092
tag_files\tag_groups.cpp,5852,88,172,bs codes,scenario_equipment_block,,h,93,536870912,000000001B922170,30357704,30365264
tag_files\tag_groups.cpp,5852,88,172,bs codes,scenario_equipment_fields_v2,,h,94,536870912,000000001B9223B0,30357792,30365436
tag_files\tag_groups.cpp,5852,120,204,bs codes,scenario_equipment_fields_v1,,h,95,536870912,000000001B8FD1D0,30357912,30365640
tag_files\tag_groups.cpp,5852,192,276,bs codes,scenario_equipment_resource_struct_definition,,h,96,536870912,000000001B93C8E0,30358104,30365916
tag_files\tag_groups.cpp,5852,56,140,bs codes,scenario_creature_palette_block,,h,97,536870912,000000001B91E0D0,30358160,30366056
tag_files\tag_groups.cpp,5852,56,140,bs codes,scenario_creature_block,,h,98,536870912,000000001B91E710,30358216,30366196
tag_files\tag_groups.cpp,5852,192,276,bs codes,scenario_creature_resource_struct_definition,,h,99,536870912,000000001B93CD60,30358408,30366472
tag_files\tag_groups.cpp,5852,56,140,bs codes,scenario_sound_scenery_palette_block,,h,100,536870912,000000001B91E530,30358464,30366612
tag_files\tag_groups.cpp,5852,80,164,bs codes,sound_scenery_datum_struct,,h,101,536870912,000000001B8F1090,30358544,30366776
tag_files\tag_groups.cpp,5852,72,156,bs codes,scenario_sound_scenery_block,,h,102,536870912,000000001B8F06F0,30358616,30366932
tag_files\tag_groups.cpp,5852,72,156,bs codes,scenario_sound_scenery_fields_v2,,h,103,536870912,000000001B8F1140,30358688,30367088
tag_files\tag_groups.cpp,5852,120,204,bs codes,scenario_sound_scenery_fields_v1,,h,104,536870912,000000001B8FCD70,30358808,30367292
tag_files\tag_groups.cpp,5852,192,276,bs codes,scenario_sound_scenery_resource_struct_definition,,h,105,536870912,000000001B93BFE0,30359000,30367568
tag_files\tag_groups.cpp,5852,72,156,bs codes,editor_comment_block,,h,106,536870912,000000001B8F0900,30359072,30367724
tag_files\tag_groups.cpp,5852,48,132,bs codes,scenario_comments_resource_struct_definition,,h,107,536870912,000000001B914360,30359120,30367856
tag_files\tag_groups.cpp,5852,104,188,bs codes,sound_effect_template_parameter_block,,h,108,536870912,000000001B93DFA0,30359224,30368044
tag_files\tag_groups.cpp,5852,120,204,bs codes,sound_effect_templates_block,,h,109,536870912,000000001B8FC9F0,30359344,30368248
tag_files\tag_groups.cpp,5852,56,140,bs codes,sound_effect_template_additional_sound_input_block,,h,110,536870912,000000001B91E170,30359400,30368388
tag_files\tag_groups.cpp,5852,80,164,bs codes,sound_effect_template_struct_definition,,h,111,536870912,000000001B8F0590,30359480,30368552
tag_files\tag_groups.cpp,5852,32,116,bs codes,stereo_system_struct_definition,,h,112,536870912,0000000000FDA2B0,30359512,30368668
tag_files\tag_groups.cpp,5852,48,132,bs codes,compression_vectors,,h,113,536870912,000000001B914D80,30359560,30368800
tag_files\tag_groups.cpp,5852,32,116,bs codes,mini_lightprobe_terms,,h,114,536870912,0000000000FDA0B0,30359592,30368916
tag_files\tag_groups.cpp,5852,176,260,bs codes,scenario_lightmap_mini_lightprobe_value_struct,,h,115,536870912,000000001B901D30,30359768,30369176
tag_files\tag_groups.cpp,5852,32,116,bs codes,lightprobe_terms,,h,116,536870912,0000000000FDA9B0,30359800,30369292
tag_files\tag_groups.cpp,5852,216,300,bs codes,scenario_lightmap_lightprobe_value,,h,117,536870912,000000001B920190,30360016,30369592
tag_files\tag_groups.cpp,5852,56,140,bs codes,scenario_lightmap_pervertex_data,,h,118,536870912,000000001B91CAF0,30360072,30369732
tag_files\tag_groups.cpp,5852,40,124,bs codes,scenario_lightmap_cluster_data,,h,119,536870912,000000001B9145A0,30360112,30369856
tag_files\tag_groups.cpp,5852,56,140,bs codes,scenario_lightmap_instance_data,,h,120,536870912,000000001B91D8B0,30360168,30369996
tag_files\tag_groups.cpp,5852,96,180,bs codes,part_block,,h,121,536870912,000000001B923670,30360264,30370176
tag_files\tag_groups.cpp,5852,56,140,bs codes,subpart_block,,h,122,536870912,000000001B91D130,30360320,30370316
tag_files\tag_groups.cpp,5852,32,116,bs codes,vertex_buffer_indices_word_array,,h,123,536870912,0000000000FDA930,30360352,30370432
tag_files\tag_groups.cpp,5852,32,116,bs codes,instance_index_word_block,,h,124,536870912,0000000000FD9AB0,30360384,30370548
tag_files\tag_groups.cpp,5852,64,148,bs codes,global_instance_bucket_block,,h,125,536870912,000000001B91CEB0,30360448,30370696
tag_files\tag_groups.cpp,5852,32,116,bs codes,indices_word_block,,h,126,536870912,0000000000FD9BB0,30360480,30370812
tag_files\tag_groups.cpp,5852,224,308,bs codes,global_mesh_block,,h,127,536870912,000000001B91FC90,30360704,30371120
tag_files\tag_groups.cpp,5852,120,204,bs codes,compression_info_block,,h,128,536870912,000000001B8FD2B0,30360824,30371324
tag_files\tag_groups.cpp,5852,32,116,bs codes,node_indices_array,,h,129,536870912,0000000000FDA330,30360856,30371440
tag_files\tag_groups.cpp,5852,32,116,bs codes,node_weights_implicit_array,,h,130,536870912,0000000000FDA030,30360888,30371556
tag_files\tag_groups.cpp,5852,168,252,bs codes,sorting_position_block,,h,131,536870912,000000001B9029F0,30361056,30371808
tag_files\tag_groups.cpp,5852,48,132,bs codes,global_render_geometry_user_data_header_struct,,h,132,536870912,000000001B914C60,30361104,30371940
tag_files\tag_groups.cpp,5852,80,164,bs codes,user_data_block,,h,133,536870912,000000001B8F04E0,30361184,30372104
tag_files\tag_groups.cpp,5852,32,116,bs codes,node_weights_complete_array,,h,134,536870912,0000000000FD9DB0,30361216,30372220
tag_files\tag_groups.cpp,5852,256,340,bs codes,raw_vertex_block,,h,135,536870912,000000001B93FEA0,30361472,30372560
tag_files\tag_groups.cpp,5852,96,180,bs codes,raw_water_append_block,,h,136,536870912,000000001B9231F0,30361568,30372740
tag_files\tag_groups.cpp,5852,72,156,bs codes,raw_water_block,,h,137,536870912,000000001B9410D0,30361640,30372896
tag_files\tag_groups.cpp,5852,120,204,bs codes,per_mesh_raw_data_block,,h,138,536870912,000000001B8FD630,30361760,30373100
tag_files\tag_groups.cpp,5852,32,116,bs codes,global_geometry_section_strip_index_block,,h,139,536870912,0000000000FD9EB0,30361792,30373216
tag_files\tag_groups.cpp,5852,88,172,bs codes,per_mesh_mopp_block,,h,140,536870912,000000001B923130,30361880,30373388
tag_files\tag_groups.cpp,5852,32,116,bs codes,node_map_byte_block,,h,141,536870912,0000000000FDA130,30361912,30373504
tag_files\tag_groups.cpp,5852,48,132,bs codes,per_mesh_node_map_block,,h,142,536870912,000000001B9134C0,30361960,30373636
tag_files\tag_groups.cpp,5852,48,132,bs codes,per_mesh_subpart_visibility_block,,h,143,536870912,000000001B914000,30362008,30373768
tag_files\tag_groups.cpp,5852,64,148,bs codes,per_instance_prt_data_block,,h,144,536870912,000000001B91CD70,30362072,30373916
tag_files\tag_groups.cpp,5852,88,172,bs codes,per_mesh_prt_data_block,,h,145,536870912,000000001B9238B0,30362160,30374088
tag_files\tag_groups.cpp,5852,64,148,bs codes,per_instance_lightmap_texcoords_block,,h,146,536870912,000000001B91D1D0,30362224,30374236
tag_files\tag_groups.cpp,5852,96,180,bs codes,vertex_buffers_block,,h,147,536870912,000000001B923970,30362320,30374416
tag_files\tag_groups.cpp,5852,88,172,bs codes,index_buffers_block,,h,148,536870912,000000001B922530,30362408,30374588
tag_files\tag_groups.cpp,5852,88,172,bs codes,render_vertex_buffer_descriptor_struct,,h,149,536870912,000000001B921DB0,30362496,30374760
tag_files\tag_groups.cpp,5852,48,132,bs codes,render_vertex_buffer_block,,h,150,536870912,000000001B913B80,30362544,30374892
tag_files\tag_groups.cpp,5852,72,156,bs codes,render_index_buffer_descriptor_struct,,h,151,536870912,000000001B941230,30362616,30375048
tag_files\tag_groups.cpp,5852,48,132,bs codes,render_index_buffer_block,,h,152,536870912,000000001B913820,30362664,30375180
tag_files\tag_groups.cpp,5852,120,204,bs codes,render_geometry_api_resource_definition_struct,,h,153,536870912,000000001B943800,30362784,30375384
tag_files\tag_groups.cpp,5852,288,372,bs codes,global_render_geometry_struct,,h,154,536870912,000000001B944020,30363072,30375756
tag_files\tag_groups.cpp,5852,264,348,bs codes,scenario_lightmap_airprobe_value,,h,155,536870912,000000001B92CA30,30363336,30376104
tag_files\tag_groups.cpp,5852,232,316,bs codes,scenario_lightmap_scenery_probe_value,,h,156,536870912,000000001B9441A0,30363568,30376420
tag_files\tag_groups.cpp,5852,240,324,bs codes,scenario_lightmap_device_machine_probe_value,,h,157,536870912,000000001B9442F0,30363808,30376744
tag_files\tag_groups.cpp,5852,112,196,bs codes,scenario_lightmap_device_machine_probe_data_value,,h,158,536870912,000000001B93E070,30363920,30376940
tag_files\tag_groups.cpp,5852,32,116,bs codes,error_point_node_index_array,,h,159,536870912,0000000000FDA1B0,30363952,30377056
tag_files\tag_groups.cpp,5852,32,116,bs codes,error_point_node_weight_array,,h,160,536870912,0000000000FDB940,30363984,30377172
tag_files\tag_groups.cpp,5852,128,212,bs codes,error_report_point_definition,,h,161,536870912,000000001B943D40,30364112,30377384
tag_files\tag_groups.cpp,5852,80,164,bs codes,error_report_vertices_block,,h,162,536870912,000000001B940D60,30364192,30377548
tag_files\tag_groups.cpp,5852,104,188,bs codes,error_report_vectors_block,,h,163,536870912,000000001B93E890,30364296,30377736
tag_files\tag_groups.cpp,5852,40,124,bs codes,error_report_line_point_array,,h,164,536870912,000000001B914E10,30364336,30377860
tag_files\tag_groups.cpp,5852,96,180,bs codes,error_report_lines_block,,h,165,536870912,000000001B922A70,30364432,30378040
tag_files\tag_groups.cpp,5852,40,124,bs codes,error_report_triangle_point_array,,h,166,536870912,000000001B913EE0,30364472,30378164
tag_files\tag_groups.cpp,5852,96,180,bs codes,error_report_triangles_block,,h,167,536870912,000000001B922CB0,30364568,30378344
tag_files\tag_groups.cpp,5852,40,124,bs codes,error_report_quad_point_array,,h,168,536870912,000000001B913940,30364608,30378468
tag_files\tag_groups.cpp,5852,96,180,bs codes,error_report_quads_block,,h,169,536870912,000000001B923430,30364704,30378648
tag_files\tag_groups.cpp,5852,112,196,bs codes,error_report_comments_block,,h,170,536870912,000000001B93E480,30364816,30378844
tag_files\tag_groups.cpp,5852,344,428,bs codes,error_reports_block,,h,171,536870912,000000001B944440,30365160,30379272
tag_files\tag_groups.cpp,5852,96,180,bs codes,global_error_report_categories_block,,h,172,536870912,000000001B923370,30365256,30379452
tag_files\tag_groups.cpp,5852,360,444,bs codes,scenario_lightmap_bsp_data_block_struct,,h,173,536870912,000000001B944600,30365616,30379896
tag_files\tag_groups.cpp,5852,64,148,bs codes,response_block,,h,174,536870912,000000001B91D270,30365680,30380044
tag_files\tag_groups.cpp,5852,248,332,bs codes,vocalization_definitions_block,,h,175,536870912,000000001B9447D0,30365928,30380376
tag_files\tag_groups.cpp,5852,208,292,bs codes,vocalization_patterns_block,,h,176,536870912,000000001B8FB5C0,30366136,30380668
tag_files\tag_groups.cpp,5852,40,124,bs codes,dialogue_data_block,,h,177,536870912,000000001B914AB0,30366176,30380792
tag_files\tag_groups.cpp,5852,40,124,bs codes,involuntary_data_block,,h,178,536870912,000000001B913040,30366216,30380916
tag_files\tag_groups.cpp,5852,160,244,bs codes,ai_dialogue_globals_struct_definition,,h,179,536870912,000000001B944930,30366376,30381160
tag_files\tag_groups.cpp,5852,56,140,bs codes,style_palette_block,,h,180,536870912,000000001B91E210,30366432,30381300
tag_files\tag_groups.cpp,5852,64,148,bs codes,squad_groups_block,,h,181,536870912,000000001B91D310,30366496,30381448
tag_files\tag_groups.cpp,5852,104,188,bs codes,patrol_point_block,,h,182,536870912,000000001B93E210,30366600,30381636
tag_files\tag_groups.cpp,5852,328,412,bs codes,actor_starting_locations_block,,h,183,536870912,000000001B944A30,30366928,30382048
tag_files\tag_groups.cpp,5852,224,308,bs codes,fire_team_block,,h,184,536870912,000000001B920050,30367152,30382356
tag_files\tag_groups.cpp,5852,128,212,bs codes,squads_struct,,h,185,536870912,000000001B9424C0,30367280,30382568
tag_files\tag_groups.cpp,5852,240,324,bs codes,old_squads_struct,,h,186,536870912,000000001B944BE0,30367520,30382892
tag_files\tag_groups.cpp,5852,136,220,bs codes,firing_positions_block,,h,187,536870912,000000001B900690,30367656,30383112
tag_files\tag_groups.cpp,5852,32,116,bs codes,area_cluster_occupancy_bitvector_array,,h,188,536870912,0000000000FDB3C0,30367688,30383228
tag_files\tag_groups.cpp,5852,56,140,bs codes,flight_reference_block,,h,189,536870912,000000001B91D950,30367744,30383368
tag_files\tag_groups.cpp,5852,184,268,bs codes,areas_block,,h,190,536870912,000000001B93C100,30367928,30383636
tag_files\tag_groups.cpp,5852,104,188,bs codes,zone_block,,h,191,536870912,000000001B93EBD0,30368032,30383824
tag_files\tag_groups.cpp,5852,56,140,bs codes,character_palette_block,,h,192,536870912,000000001B91E850,30368088,30383964
tag_files\tag_groups.cpp,5852,40,124,bs codes,ai_recording_reference_block,,h,193,536870912,000000001B913700,30368128,30384088
tag_files\tag_groups.cpp,5852,104,188,bs codes,cs_point_block,,h,194,536870912,000000001B93E140,30368232,30384276
tag_files\tag_groups.cpp,5852,80,164,bs codes,cs_point_set_block,,h,195,536870912,000000001B940470,30368312,30384440
tag_files\tag_groups.cpp,5852,56,140,bs codes,cs_script_data_block,,h,196,536870912,000000001B91D450,30368368,30384580
tag_files\tag_groups.cpp,5852,64,148,bs codes,zone_set_block,,h,197,536870912,000000001B91D4F0,30368432,30384728
tag_files\tag_groups.cpp,5852,64,148,bs codes,secondary_zone_set_block,,h,198,536870912,000000001B91DBD0,30368496,30384876
tag_files\tag_groups.cpp,5852,48,132,bs codes,trigger_references,,h,199,536870912,000000001B914510,30368544,30385008
tag_files\tag_groups.cpp,5852,64,148,bs codes,secondary_set_trigger_block,,h,200,536870912,000000001B91DD10,30368608,30385156
tag_files\tag_groups.cpp,5852,32,116,bs codes,special_movement_block,,h,201,536870912,0000000000FDB340,30368640,30385272
tag_files\tag_groups.cpp,5852,88,172,bs codes,order_ending_block,,h,202,536870912,000000001B922E30,30368728,30385444
tag_files\tag_groups.cpp,5852,56,140,bs codes,pureform_distribution_block,,h,203,536870912,000000001B91D630,30368784,30385584
tag_files\tag_groups.cpp,5852,248,332,bs codes,orders_block,,h,204,536870912,000000001B944D30,30369032,30385916
tag_files\tag_groups.cpp,5852,112,196,bs codes,order_completion_condition,,h,205,536870912,000000001B93E960,30369144,30386112
tag_files\tag_groups.cpp,5852,80,164,bs codes,triggers_block,,h,206,536870912,000000001B940E10,30369224,30386276
tag_files\tag_groups.cpp,5852,64,148,bs codes,ai_scene_trigger_block,,h,207,536870912,000000001B91D6D0,30369288,30386424
tag_files\tag_groups.cpp,5852,32,116,bs codes,ai_scene_role_variants_block,,h,208,536870912,000000001B945B60,30369320,30386540
tag_files\tag_groups.cpp,5852,72,156,bs codes,ai_scene_role_block,,h,209,536870912,000000001B941390,30369392,30386696
tag_files\tag_groups.cpp,5852,88,172,bs codes,ai_scene_block,,h,210,536870912,000000001B923A30,30369480,30386868
tag_files\tag_groups.cpp,5852,56,140,bs codes,flock_palette_block,,h,211,536870912,000000001B91D590,30369536,30387008
tag_files\tag_groups.cpp,5852,112,196,bs codes,flock_source_block,,h,212,536870912,000000001B93DED0,30369648,30387204
tag_files\tag_groups.cpp,5852,56,140,bs codes,flock_sink_block,,h,213,536870912,000000001B91D9F0,30369704,30387344
tag_files\tag_groups.cpp,5852,200,284,bs codes,flock_instance_block,,h,214,536870912,000000001B8FBE10,30369904,30387628
tag_files\tag_groups.cpp,5852,176,260,bs codes,scenario_trigger_volume_struct,,h,215,536870912,000000001B902B00,30370080,30387888
tag_files\tag_groups.cpp,5852,32,116,bs codes,scenario_trigger_volume_parameter_storage_array,,h,216,536870912,000000001B9466E0,30370112,30388004
tag_files\tag_groups.cpp,5852,96,180,bs codes,scenario_trigger_volume_fields_v0,,h,217,536870912,000000001B922470,30370208,30388184
tag_files\tag_groups.cpp,5852,56,140,bs codes,script_fragment_block,,h,218,536870912,000000001B91DDB0,30370264,30388324
tag_files\tag_groups.cpp,5852,104,188,bs codes,task_direction_block,,h,219,536870912,000000001B93ECA0,30370368,30388512
tag_files\tag_groups.cpp,5852,360,444,bs codes,tasks_block,,h,220,536870912,000000001B947EB0,30370728,30388956
tag_files\tag_groups.cpp,5852,72,156,bs codes,objectives_block,,h,221,536870912,000000001B941860,30370800,30389112
tag_files\tag_groups.cpp,5852,480,564,bs codes,scenario_ai_resource_struct_definition,,h,222,536870912,000000001B948080,30371280,30389676
tag_files\tag_groups.cpp,5852,160,244,bs codes,antenna_vertex_block,,h,223,536870912,000000001B9482C0,30371440,30389920
tag_files\tag_groups.cpp,5852,176,260,bs codes,antenna_struct_definition,,h,224,536870912,000000001B900E50,30371616,30390180
tag_files\tag_groups.cpp,5852,168,252,bs codes,shader_beam_struct_definition,,h,225,536870912,000000001B901070,30371784,30390432
tag_files\tag_groups.cpp,5852,96,180,bs codes,beam_property_real,,h,226,536870912,000000001B923070,30371880,30390612
tag_files\tag_groups.cpp,5852,128,212,bs codes,beam_property_real_point2d,,h,227,536870912,000000001B943C60,30372008,30390824
tag_files\tag_groups.cpp,5852,96,180,bs codes,beam_property_real_rgb_color,,h,228,536870912,000000001B922B30,30372104,30391004
tag_files\tag_groups.cpp,5852,32,116,bs codes,gpu_property_sub_array,,h,229,536870912,000000001B946760,30372136,30391120
tag_files\tag_groups.cpp,5852,64,148,bs codes,gpu_property_block,,h,230,536870912,000000001B91DE50,30372200,30391268
tag_files\tag_groups.cpp,5852,32,116,bs codes,gpu_function_sub_array,,h,231,536870912,000000001B9452E0,30372232,30391384
tag_files\tag_groups.cpp,5852,64,148,bs codes,gpu_function_block,,h,232,536870912,000000001B91DEF0,30372296,30391532
tag_files\tag_groups.cpp,5852,32,116,bs codes,gpu_color_sub_array,,h,233,536870912,000000001B945160,30372328,30391648
tag_files\tag_groups.cpp,5852,64,148,bs codes,gpu_color_block,,h,234,536870912,0000000000FCE880,30372392,30391796
tag_files\tag_groups.cpp,5852,96,180,bs codes,gpu_property_function_color_struct,,h,235,536870912,000000001B9232B0,30372488,30391976
tag_files\tag_groups.cpp,5852,352,436,bs codes,beam_definition_block,,h,236,536870912,000000001B9483C0,30372840,30392412
tag_files\tag_groups.cpp,5852,48,132,bs codes,beam_system_struct_definition,,h,237,536870912,000000001B913AF0,30372888,30392544
tag_files\tag_groups.cpp,5852,64,148,bs codes,bink_resource_struct,,h,238,536870912,000000001B9485D0,30372952,30392692
tag_files\tag_groups.cpp,5852,48,132,bs codes,bink_struct_definition,,h,239,536870912,000000001B914630,30373000,30392824
tag_files\tag_groups.cpp,5852,104,188,bs codes,object_early_mover_obb_block,,h,240,536870912,000000001B93E2E0,30373104,30393012
tag_files\tag_groups.cpp,5852,56,140,bs codes,object_ai_properties_block,,h,241,536870912,000000001B94A010,30373160,30393152
tag_files\tag_groups.cpp,5852,88,172,bs codes,object_function_block,,h,242,536870912,000000001B922EF0,30373248,30393324
tag_files\tag_groups.cpp,5852,96,180,bs codes,object_attachment_block,,h,243,536870912,000000001B9225F0,30373344,30393504
tag_files\tag_groups.cpp,5852,56,140,bs codes,object_widget_block,,h,244,536870912,000000001B9488F0,30373400,30393644
tag_files\tag_groups.cpp,5852,88,172,bs codes,object_change_color_initial_permutation,,h,245,536870912,000000001B921B70,30373488,30393816
tag_files\tag_groups.cpp,5852,96,180,bs codes,object_change_color_function,,h,246,536870912,000000001B922770,30373584,30393996
tag_files\tag_groups.cpp,5852,72,156,bs codes,object_change_colors,,h,247,536870912,000000001B941910,30373656,30394152
tag_files\tag_groups.cpp,5852,456,540,bs codes,multiplayer_object_block,,h,248,536870912,000000001B94A990,30374112,30394692
tag_files\tag_groups.cpp,5852,56,140,bs codes,object_health_pack_block,,h,249,536870912,000000001B949CF0,30374168,30394832
tag_files\tag_groups.cpp,5852,552,636,bs codes,object_struct_definition,,h,250,536870912,000000001B94ABC0,30374720,30395468
tag_files\tag_groups.cpp,5852,72,156,bs codes,campaign_metagame_bucket_block,,h,251,536870912,000000001B941700,30374792,30395624
tag_files\tag_groups.cpp,5852,56,140,bs codes,unit_camera_track_block,,h,252,536870912,000000001B948CB0,30374848,30395764
tag_files\tag_groups.cpp,5852,72,156,bs codes,unit_camera_acceleration_displacment_function_struct,,h,253,536870912,000000001B940260,30374920,30395920
tag_files\tag_groups.cpp,5852,80,164,bs codes,unit_camera_acceleration_displacment_function_block,,h,254,536870912,000000001B941D30,30375000,30396084
tag_files\tag_groups.cpp,5852,152,236,bs codes,unit_camera_struct,,h,255,536870912,000000001B94B0A0,30375152,30396320
tag_files\tag_groups.cpp,5852,64,148,bs codes,unit_seat_acceleration_struct,,h,256,536870912,000000001B948670,30375216,30396468
tag_files\tag_groups.cpp,5852,32,116,bs codes,unit_additional_node_names_struct,,h,257,536870912,000000001B945360,30375248,30396584
tag_files\tag_groups.cpp,5852,24,108,bs codes,unit_additional_node_names_v1,,h,258,536870912,000000001B946C60,30375272,30396692
tag_files\tag_groups.cpp,5852,248,332,bs codes,unit_boarding_melee_struct,,h,259,536870912,000000001B94CE60,30375520,30397024
tag_files\tag_groups.cpp,5852,184,268,bs codes,unit_boarding_melee_fields_v2,,h,260,536870912,000000001B93D420,30375704,30397292
tag_files\tag_groups.cpp,5852,24,108,bs codes,unit_boarding_melee_fields_v1,,h,261,536870912,000000001B946CE0,30375728,30397400
tag_files\tag_groups.cpp,5852,56,140,bs codes,unit_hud_reference_block,,h,262,536870912,000000001B9499D0,30375784,30397540
tag_files\tag_groups.cpp,5852,40,124,bs codes,powered_seat_block,,h,263,536870912,000000001B912F20,30375824,30397664
tag_files\tag_groups.cpp,5852,56,140,bs codes,unit_weapon_block,,h,264,536870912,000000001B949110,30375880,30397804
tag_files\tag_groups.cpp,5852,328,412,bs codes,unit_seat_block,,h,265,536870912,000000001B94CFC0,30376208,30398216
tag_files\tag_groups.cpp,5852,360,444,bs codes,unit_seat_fields_v3,,h,266,536870912,000000001B94D170,30376568,30398660
tag_files\tag_groups.cpp,5852,280,364,bs codes,unit_seat_fields_v2,,h,267,536870912,000000001B94D340,30376848,30399024
tag_files\tag_groups.cpp,5852,248,332,bs codes,unit_seat_fields_v1,,h,268,536870912,000000001B94D4C0,30377096,30399356
tag_files\tag_groups.cpp,5852,96,180,bs codes,unit_boost_struct,,h,269,536870912,000000001B921C30,30377192,30399536
tag_files\tag_groups.cpp,5852,584,668,bs codes,unit_struct_definition,,h,270,536870912,000000001B94D620,30377776,30400204
tag_files\tag_groups.cpp,5852,568,652,bs codes,unit_struct_definition,,h,271,536870912,000000001B94D8D0,30378344,30400856
tag_files\tag_groups.cpp,5852,40,124,bs codes,biped_lock_on_data_struct,,h,272,536870912,000000001B913C10,30378384,30400980
tag_files\tag_groups.cpp,5852,24,108,bs codes,biped_lock_on_data_fields_v1,,h,273,536870912,000000001B946160,30378408,30401088
tag_files\tag_groups.cpp,5852,112,196,bs codes,havok_primitive_struct,,h,274,536870912,000000001B93E3B0,30378520,30401284
tag_files\tag_groups.cpp,5852,80,164,bs codes,havok_shape_struct,,h,275,536870912,000000001B940EC0,30378600,30401448
tag_files\tag_groups.cpp,5852,56,140,bs codes,havok_convex_shape_struct,,h,276,536870912,000000001B949B10,30378656,30401588
tag_files\tag_groups.cpp,5852,48,132,bs codes,havok_shape_reference_struct,,h,277,536870912,000000001B9139D0,30378704,30401720
tag_files\tag_groups.cpp,5852,112,196,bs codes,havok_convex_translate_shape_struct,,h,278,536870912,000000001B93EB00,30378816,30401916
tag_files\tag_groups.cpp,5852,80,164,bs codes,spheres_block_struct,,h,279,536870912,000000001B941B20,30378896,30402080
tag_files\tag_groups.cpp,5852,56,140,bs codes,transform_shape_quaternion_struct,,h,280,536870912,000000001B949D90,30378952,30402220
tag_files\tag_groups.cpp,5852,24,108,bs codes,transform_shape_tag_struct_fields_v1,,h,281,536870912,000000001B9467E0,30378976,30402328
tag_files\tag_groups.cpp,5852,208,292,bs codes,havok_transform_shape_struct,,h,282,536870912,000000001B8FC1A0,30379184,30402620
tag_files\tag_groups.cpp,5852,80,164,bs codes,old_spheres_block,,h,283,536870912,000000001B941DE0,30379264,30402784
tag_files\tag_groups.cpp,5852,128,212,bs codes,pills_block,,h,284,536870912,000000001B9438E0,30379392,30402996
tag_files\tag_groups.cpp,5852,152,236,bs codes,character_physics_ground_struct,,h,285,536870912,000000001B94B7A0,30379544,30403232
tag_files\tag_groups.cpp,5852,120,204,bs codes,character_physics_flying_struct,,h,286,536870912,000000001B9425A0,30379664,30403436
tag_files\tag_groups.cpp,5852,200,284,bs codes,character_physics_struct,,h,287,536870912,000000001B8FBA80,30379864,30403720
tag_files\tag_groups.cpp,5852,32,116,bs codes,contact_point_block,,h,288,536870912,000000001B946860,30379896,30403836
tag_files\tag_groups.cpp,5852,120,204,bs codes,biped_leaping_data_struct,,h,289,536870912,000000001B942A00,30380016,30404040
tag_files\tag_groups.cpp,5852,120,204,bs codes,biped_ground_fitting_data_struct,,h,290,536870912,000000001B9431E0,30380136,30404244
tag_files\tag_groups.cpp,5852,24,108,bs codes,biped_ground_fitting_data_fields_v1,,h,291,536870912,000000001B9458E0,30380160,30404352
tag_files\tag_groups.cpp,5852,496,580,bs codes,biped_group,,h,292,536870912,000000001B94DB70,30380656,30404932
tag_files\tag_groups.cpp,5852,1552,1636,bs codes,biped_group,,h,293,536870912,000000001B94DDC0,30382208,30406568
tag_files\tag_groups.cpp,5852,40,124,bs codes,contact_point_block_v1,,h,294,536870912,000000001B914A20,30382248,30406692
tag_files\tag_groups.cpp,5852,1672,1756,bs codes,biped_definition_tags_v1,,h,295,536870912,000000001B94E430,30383920,30408448
tag_files\tag_groups.cpp,5852,168,252,bs codes,bitmap_usage_block,,h,296,536870912,000000001B901180,30384088,30408700
tag_files\tag_groups.cpp,5852,96,180,bs codes,bitmap_group_sprite_block_def,,h,297,536870912,000000001B921CF0,30384184,30408880
tag_files\tag_groups.cpp,5852,80,164,bs codes,bitmap_group_sequence_block_def,,h,298,536870912,000000001B9417B0,30384264,30409044
tag_files\tag_groups.cpp,5852,192,276,bs codes,bitmap_data_block_def,,h,299,536870912,000000001B93CA00,30384456,30409320
tag_files\tag_groups.cpp,5852,144,228,bs codes,bitmap_tags_v1,,h,300,536870912,000000001B900780,30384600,30409548
tag_files\tag_groups.cpp,5852,184,268,bs codes,render_texture_interop_definition_struct,,h,301,536870912,000000001B93CE80,30384784,30409816
tag_files\tag_groups.cpp,5852,48,132,bs codes,bitmap_texture_interop_resource_struct,,h,302,536870912,000000001B914090,30384832,30409948
tag_files\tag_groups.cpp,5852,40,124,bs codes,bitmap_texture_interop_block_struct,,h,303,536870912,000000001B913CA0,30384872,30410072
tag_files\tag_groups.cpp,5852,104,188,bs codes,render_texture_format_definition,,h,304,536870912,000000001B93E550,30384976,30410260
tag_files\tag_groups.cpp,5852,144,228,bs codes,render_texture_interleaved_interop_definition_struct,,h,305,536870912,000000001B900870,30385120,30410488
tag_files\tag_groups.cpp,5852,48,132,bs codes,bitmap_texture_interleaved_interop_resource_struct,,h,306,536870912,000000001B9138B0,30385168,30410620
tag_files\tag_groups.cpp,5852,40,124,bs codes,bitmap_texture_interleaved_interop_block_struct,,h,307,536870912,000000001B914B40,30385208,30410744
tag_files\tag_groups.cpp,5852,376,460,bs codes,bitmap_block_struct,,h,308,536870912,000000001B912690,30385584,30411204
tag_files\tag_groups.cpp,5852,224,308,bs codes,text_widget_block,,h,309,536870912,000000001B920910,30385808,30411512
tag_files\tag_groups.cpp,5852,296,380,bs codes,bitmap_widget_block,,h,310,536870912,000000001B950B30,30386104,30411892
tag_files\tag_groups.cpp,5852,232,316,bs codes,gui_button_key_definition_struct_definition,,h,311,536870912,000000001B950CC0,30386336,30412208
tag_files\tag_groups.cpp,5852,88,172,bs codes,crate_struct_definition,,h,312,536870912,000000001B9234F0,30386424,30412380
tag_files\tag_groups.cpp,5852,600,684,bs codes,crate_struct_definition,,h,313,536870912,000000001B950E10,30387024,30413064
tag_files\tag_groups.cpp,5852,264,348,bs codes,gui_bitmap_widget_definition_struct_definition,,h,314,536870912,000000001B92CFF0,30387288,30413412
tag_files\tag_groups.cpp,5852,144,228,bs codes,particle_property_real_point3d_struct_new,,h,315,536870912,000000001B900000,30387432,30413640
tag_files\tag_groups.cpp,5852,48,132,bs codes,property_editable_vector3d_interpolator,,h,316,536870912,000000001B913790,30387480,30413772
tag_files\tag_groups.cpp,5852,128,212,bs codes,particle_property_real_vector3d_spherical_struct_new,,h,317,536870912,000000001B943E20,30387608,30413984
tag_files\tag_groups.cpp,5852,96,180,bs codes,particle_property_scalar_struct_new,,h,318,536870912,000000001B922830,30387704,30414164
tag_files\tag_groups.cpp,5852,48,132,bs codes,particle_controller_parameters,,h,319,536870912,000000001B913DC0,30387752,30414296
tag_files\tag_groups.cpp,5852,80,164,bs codes,particle_controller,,h,320,536870912,000000001B941440,30387832,30414460
tag_files\tag_groups.cpp,5852,88,172,bs codes,particle_physics_struct,,h,321,536870912,000000001B9235B0,30387920,30414632
tag_files\tag_groups.cpp,5852,144,228,bs codes,particle_property_real_vector3d_struct_new,,h,322,536870912,000000001B8FFD30,30388064,30414860
tag_files\tag_groups.cpp,5852,96,180,bs codes,particle_property_color_struct_new,,h,323,536870912,000000001B923730,30388160,30415040
tag_files\tag_groups.cpp,5852,440,524,bs codes,particle_system_emitter_definition_block,,h,324,536870912,000000000108B1F0,30388600,30415564
tag_files\tag_groups.cpp,5852,240,324,bs codes,particle_system_definition_block_new,,h,325,536870912,000000001B9510D0,30388840,30415888
tag_files\tag_groups.cpp,5852,192,276,bs codes,breakable_surface_struct_definition,,h,326,536870912,000000001B93DAE0,30389032,30416164
tag_files\tag_groups.cpp,5852,104,188,bs codes,collision_damage_struct_definition,,h,327,536870912,000000001B93E620,30389136,30416352
tag_files\tag_groups.cpp,5852,96,180,bs codes,camera_fx_exposure_struct,,h,328,536870912,000000001B921E70,30389232,30416532
tag_files\tag_groups.cpp,5852,48,132,bs codes,camera_fx_exposure_sensitivity_struct,,h,329,536870912,000000001B914750,30389280,30416664
tag_files\tag_groups.cpp,5852,48,132,bs codes,camera_fx_exposure_anti_bloom_struct,,h,330,536870912,000000001B913E50,30389328,30416796
tag_files\tag_groups.cpp,5852,64,148,bs codes,camera_fx_bloom_point_struct,,h,331,536870912,000000001B949390,30389392,30416944
tag_files\tag_groups.cpp,5852,64,148,bs codes,camera_fx_bloom_inherent_struct,,h,332,536870912,000000001B9496B0,30389456,30417092
tag_files\tag_groups.cpp,5852,64,148,bs codes,camera_fx_bloom_intensity_struct,,h,333,536870912,000000001B949F70,30389520,30417240
tag_files\tag_groups.cpp,5852,64,148,bs codes,camera_fx_bloom_large_color_struct,,h,334,536870912,000000001B9491B0,30389584,30417388
tag_files\tag_groups.cpp,5852,64,148,bs codes,camera_fx_bloom_medium_color_struct,,h,335,536870912,000000001B9492F0,30389648,30417536
tag_files\tag_groups.cpp,5852,64,148,bs codes,camera_fx_bloom_small_color_struct,,h,336,536870912,000000001B948B70,30389712,30417684
tag_files\tag_groups.cpp,5852,64,148,bs codes,camera_fx_bling_intensity_struct,,h,337,536870912,000000001B949ED0,30389776,30417832
tag_files\tag_groups.cpp,5852,64,148,bs codes,camera_fx_bling_size_struct,,h,338,536870912,000000001B948D50,30389840,30417980
tag_files\tag_groups.cpp,5852,64,148,bs codes,camera_fx_bling_angle_struct,,h,339,536870912,000000001B949BB0,30389904,30418128
tag_files\tag_groups.cpp,5852,40,124,bs codes,camera_fx_bling_count_struct,,h,340,536870912,000000001B913F70,30389944,30418252
tag_files\tag_groups.cpp,5852,64,148,bs codes,camera_fx_self_illum_preferred_struct,,h,341,536870912,000000001B949C50,30390008,30418400
tag_files\tag_groups.cpp,5852,64,148,bs codes,camera_fx_self_illum_scale_struct,,h,342,536870912,000000001B94A330,30390072,30418548
tag_files\tag_groups.cpp,5852,56,140,bs codes,camera_fx_ssao_struct,,h,343,536870912,000000001B949570,30390128,30418688
tag_files\tag_groups.cpp,5852,40,124,bs codes,color_grading_scalar_function_struct,,h,344,536870912,000000001B9147E0,30390168,30418812
tag_files\tag_groups.cpp,5852,104,188,bs codes,color_grading_curves_editor_block,,h,345,536870912,000000001B93E6F0,30390272,30419000
tag_files\tag_groups.cpp,5852,48,132,bs codes,color_grading_brightness_contrast_block,,h,346,536870912,000000001B914120,30390320,30419132
tag_files\tag_groups.cpp,5852,64,148,bs codes,color_grading_hslv_block,,h,347,536870912,000000001B94A0B0,30390384,30419280
tag_files\tag_groups.cpp,5852,64,148,bs codes,color_grading_colorize_effect_block,,h,348,536870912,000000001B948990,30390448,30419428
tag_files\tag_groups.cpp,5852,56,140,bs codes,color_grading_cmyb_struct,,h,349,536870912,000000001B948A30,30390504,30419568
tag_files\tag_groups.cpp,5852,176,260,bs codes,color_grading_selective_color_block,,h,350,536870912,0000000000FBBCE0,30390680,30419828
tag_files\tag_groups.cpp,5852,48,132,bs codes,color_grading_cmy_struct,,h,351,536870912,000000001B912FB0,30390728,30419960
tag_files\tag_groups.cpp,5852,80,164,bs codes,color_grading_color_balance_block,,h,352,536870912,000000001B941180,30390808,30420124
tag_files\tag_groups.cpp,5852,184,268,bs codes,camera_fx_color_grading_struct,,h,353,536870912,000000001B93BEC0,30390992,30420392
tag_files\tag_groups.cpp,5852,112,196,bs codes,camera_fx_lightshafts_struct,,h,354,536870912,000000001B93E7C0,30391104,30420588
tag_files\tag_groups.cpp,5852,312,396,bs codes,camera_fx_settings_block,,h,355,536870912,000000001B951220,30391416,30420984
tag_files\tag_groups.cpp,5852,32,116,bs codes,chud_keyframe_base_struct,,h,356,536870912,000000001B9450E0,30391448,30421100
tag_files\tag_groups.cpp,5852,64,148,bs codes,chud_keyframe_position_block,,h,357,536870912,000000001B949750,30391512,30421248
tag_files\tag_groups.cpp,5852,64,148,bs codes,chud_animation_position_block,,h,358,536870912,000000001B948710,30391576,30421396
tag_files\tag_groups.cpp,5852,64,148,bs codes,chud_keyframe_rotation_block,,h,359,536870912,000000001B949430,30391640,30421544
tag_files\tag_groups.cpp,5852,64,148,bs codes,chud_animation_rotation_block,,h,360,536870912,000000001B949250,30391704,30421692
tag_files\tag_groups.cpp,5852,56,140,bs codes,chud_keyframe_scale_block,,h,361,536870912,000000001B9487B0,30391760,30421832
tag_files\tag_groups.cpp,5852,64,148,bs codes,chud_animation_scale_block,,h,362,536870912,000000001B9497F0,30391824,30421980
tag_files\tag_groups.cpp,5852,56,140,bs codes,chud_keyframe_color_block,,h,363,536870912,000000001B948850,30391880,30422120
tag_files\tag_groups.cpp,5852,64,148,bs codes,chud_animation_color_block,,h,364,536870912,000000001B94A150,30391944,30422268
tag_files\tag_groups.cpp,5852,48,132,bs codes,chud_keyframe_scalar_block,,h,365,536870912,000000001B914BD0,30391992,30422400
tag_files\tag_groups.cpp,5852,64,148,bs codes,chud_animation_scalar_block,,h,366,536870912,000000001B948AD0,30392056,30422548
tag_files\tag_groups.cpp,5852,72,156,bs codes,chud_keyframe_texture_block,,h,367,536870912,000000001B941650,30392128,30422704
tag_files\tag_groups.cpp,5852,64,148,bs codes,chud_animation_texture_block,,h,368,536870912,000000001B948C10,30392192,30422852
tag_files\tag_groups.cpp,5852,216,300,bs codes,chud_animation_definition_struct_definition,,h,369,536870912,000000001B920550,30392408,30423152
tag_files\tag_groups.cpp,5852,72,156,bs codes,character_voice_block,,h,370,536870912,000000001B940310,30392480,30423308
tag_files\tag_groups.cpp,5852,72,156,bs codes,character_variants_block,,h,371,536870912,000000001B941F40,30392552,30423464
tag_files\tag_groups.cpp,5852,48,132,bs codes,character_voice_properties_block,,h,372,536870912,000000001B9141B0,30392600,30423596
tag_files\tag_groups.cpp,5852,104,188,bs codes,character_general_block,,h,373,536870912,000000001B93EA30,30392704,30423784
tag_files\tag_groups.cpp,5852,280,364,bs codes,character_vitality_block,,h,374,536870912,000000001B9513C0,30392984,30424148
tag_files\tag_groups.cpp,5852,128,212,bs codes,character_placement_block,,h,375,536870912,000000001B943560,30393112,30424360
tag_files\tag_groups.cpp,5852,112,196,bs codes,character_perception_block,,h,376,536870912,000000001B93ED70,30393224,30424556
tag_files\tag_groups.cpp,5852,184,268,bs codes,character_look_block,,h,377,536870912,000000001B93D540,30393408,30424824
tag_files\tag_groups.cpp,5852,136,220,bs codes,character_movement_block,,h,378,536870912,000000001B8FFE20,30393544,30425044
tag_files\tag_groups.cpp,5852,72,156,bs codes,character_flocking_block,,h,379,536870912,000000001B940AA0,30393616,30425200
tag_files\tag_groups.cpp,5852,144,228,bs codes,character_swarm_block,,h,380,536870912,000000001B8FFF10,30393760,30425428
tag_files\tag_groups.cpp,5852,40,124,bs codes,character_ready_block,,h,381,536870912,0000000001079760,30393800,30425552
tag_files\tag_groups.cpp,5852,104,188,bs codes,character_engage_block,,h,382,536870912,000000001B9518D0,30393904,30425740
tag_files\tag_groups.cpp,5852,48,132,bs codes,character_charge_difficulty_limits_block,,h,383,536870912,000000001B9552E0,30393952,30425872
tag_files\tag_groups.cpp,5852,272,356,bs codes,character_charge_block,,h,384,536870912,000000001B92C5E0,30394224,30426228
tag_files\tag_groups.cpp,5852,64,148,bs codes,character_evasion_block,,h,385,536870912,000000001B949E30,30394288,30426376
tag_files\tag_groups.cpp,5852,192,276,bs codes,character_cover_block,,h,386,536870912,000000001B93CB20,30394480,30426652
tag_files\tag_groups.cpp,5852,200,284,bs codes,character_retreat_block,,h,387,536870912,000000001B8FAD70,30394680,30426936
tag_files\tag_groups.cpp,5852,88,172,bs codes,character_search_block,,h,388,536870912,000000001B9228F0,30394768,30427108
tag_files\tag_groups.cpp,5852,104,188,bs codes,character_presearch_block,,h,389,536870912,000000001B951590,30394872,30427296
tag_files\tag_groups.cpp,5852,48,132,bs codes,character_idle_block,,h,390,536870912,000000001B955370,30394920,30427428
tag_files\tag_groups.cpp,5852,48,132,bs codes,character_vocalization_block,,h,391,536870912,000000001B9535A0,30394968,30427560
tag_files\tag_groups.cpp,5852,64,148,bs codes,character_boarding_block,,h,392,536870912,000000001B948DF0,30395032,30427708
tag_files\tag_groups.cpp,5852,72,156,bs codes,character_guardian_block,,h,393,536870912,000000001B9409F0,30395104,30427864
tag_files\tag_groups.cpp,5852,40,124,bs codes,character_combatform_block,,h,394,536870912,000000001B953870,30395144,30427988
tag_files\tag_groups.cpp,5852,72,156,bs codes,character_scarab_block,,h,395,536870912,000000001B940CB0,30395216,30428144
tag_files\tag_groups.cpp,5852,152,236,bs codes,character_firing_pattern_block,,h,396,536870912,000000001B94BFA0,30395368,30428380
tag_files\tag_groups.cpp,5852,488,572,bs codes,character_weapons_block,,h,397,536870912,000000001B955560,30395856,30428952
tag_files\tag_groups.cpp,5852,80,164,bs codes,character_firing_pattern_properties_block,,h,398,536870912,000000001B941020,30395936,30429116
tag_files\tag_groups.cpp,5852,168,252,bs codes,character_grenades_block,,h,399,536870912,000000001B9565D0,30396104,30429368
tag_files\tag_groups.cpp,5852,456,540,bs codes,character_vehicle_block,,h,400,536870912,000000001B9577C0,30396560,30429908
tag_files\tag_groups.cpp,5852,480,564,bs codes,character_morph_block,,h,401,536870912,000000001B9579F0,30397040,30430472
tag_files\tag_groups.cpp,5852,56,140,bs codes,character_equipment_usage_block,,h,402,536870912,000000001B949A70,30397096,30430612
tag_files\tag_groups.cpp,5852,96,180,bs codes,character_equipment_block,,h,403,536870912,0000000000FA3B60,30397192,30430792
tag_files\tag_groups.cpp,5852,80,164,bs codes,character_activity_object_block,,h,404,536870912,000000001B941A70,30397272,30430956
tag_files\tag_groups.cpp,5852,960,1044,bs codes,character_struct_definition,,h,405,536870912,000000001B957C30,30398232,30432000
tag_files\tag_groups.cpp,5852,184,268,bs codes,chud_widget_state_data_block,,h,406,536870912,000000001B93CC40,30398416,30432268
tag_files\tag_groups.cpp,5852,88,172,bs codes,chud_widget_placement_data_block,,h,407,536870912,0000000000FA3620,30398504,30432440
tag_files\tag_groups.cpp,5852,72,156,bs codes,chud_widget_animation_block_struct,,h,408,536870912,000000001B9403C0,30398576,30432596
tag_files\tag_groups.cpp,5852,120,204,bs codes,chud_widget_animation_data_block,,h,409,536870912,000000001B943B80,30398696,30432800
tag_files\tag_groups.cpp,5852,216,300,bs codes,chud_widget_render_data_block,,h,410,536870912,000000001B91FDD0,30398912,30433100
tag_files\tag_groups.cpp,5852,152,236,bs codes,chud_widget_base_struct,,h,411,536870912,000000001B94C7A0,30399064,30433336
tag_files\tag_groups.cpp,5852,112,196,bs codes,chud_widget_bitmap_block,,h,412,536870912,000000001B9520F0,30399176,30433532
tag_files\tag_groups.cpp,5852,80,164,bs codes,chud_widget_text_block,,h,413,536870912,000000001B9414F0,30399256,30433696
tag_files\tag_groups.cpp,5852,88,172,bs codes,chud_widget_collection_block,,h,414,536870912,0000000000FA3C20,30399344,30433868
tag_files\tag_groups.cpp,5852,48,132,bs codes,chud_definition_info_struct,,h,415,536870912,000000001B954200,30399392,30434000
tag_files\tag_groups.cpp,5852,64,148,bs codes,chud_definition_struct_definition,,h,416,536870912,000000001B948E90,30399456,30434148
tag_files\tag_groups.cpp,5852,224,308,bs codes,chud_curvature_info_block,,h,417,536870912,000000001B91FF10,30399680,30434456
tag_files\tag_groups.cpp,5852,64,148,bs codes,chud_sound_character_block,,h,418,536870912,000000001B9494D0,30399744,30434604
tag_files\tag_groups.cpp,5852,64,148,bs codes,chud_sound_block,,h,419,536870912,000000001B948F30,30399808,30434752
tag_files\tag_groups.cpp,5852,32,116,bs codes,chud_medal_name_block,,h,420,536870912,000000001B9468E0,30399840,30434868
tag_files\tag_groups.cpp,5852,72,156,bs codes,chud_config_info_block_struct,,h,421,536870912,000000001B940940,30399912,30435024
tag_files\tag_groups.cpp,5852,904,988,bs codes,chud_skin_info_block,,h,422,536870912,000000001B958050,30400816,30436012
tag_files\tag_groups.cpp,5852,88,172,bs codes,chud_shader_block,,h,423,536870912,000000001B959090,30400904,30436184
tag_files\tag_groups.cpp,5852,88,172,bs codes,player_training_entry_data_block,,h,424,536870912,000000001B95A050,30400992,30436356
tag_files\tag_groups.cpp,5852,504,588,bs codes,chud_globals_definition_struct_definition,,h,425,536870912,000000001B95A450,30401496,30436944
tag_files\tag_groups.cpp,5852,32,116,bs codes,per_object_type_relative_min_luminance_block,,h,426,536870912,000000001B9454E0,30401528,30437060
tag_files\tag_groups.cpp,5852,48,132,bs codes,chocolate_mountain_new_struct_definition,,h,427,536870912,000000001B9543B0,30401576,30437192
tag_files\tag_groups.cpp,5852,56,140,bs codes,scenario_cinematics_block,,h,428,536870912,000000001B948FD0,30401632,30437332
tag_files\tag_groups.cpp,5852,88,172,bs codes,scenario_cutscene_flag_block,,h,429,536870912,000000001B958B50,30401720,30437504
tag_files\tag_groups.cpp,5852,96,180,bs codes,scenario_cutscene_camera_point_block,,h,430,536870912,000000001B9586D0,30401816,30437684
tag_files\tag_groups.cpp,5852,128,212,bs codes,recorded_animation_block,,h,431,536870912,000000001B9423E0,30401944,30437896
tag_files\tag_groups.cpp,5852,144,228,bs codes,scenario_cinematics_resource_struct_definition,,h,432,536870912,000000001B900960,30402088,30438124
tag_files\tag_groups.cpp,5852,32,116,bs codes,cinematic_shot_playback_data_block,,h,433,536870912,000000001B9460E0,30402120,30438240
tag_files\tag_groups.cpp,5852,56,140,bs codes,cinematic_playback_data_block,,h,434,536870912,000000001B949610,30402176,30438380
tag_files\tag_groups.cpp,5852,64,148,bs codes,scenario_and_zone_set_struct,,h,435,536870912,000000001B949890,30402240,30438528
tag_files\tag_groups.cpp,5852,64,148,bs codes,cinematic_custom_script_block,,h,436,536870912,000000001B949930,30402304,30438676
tag_files\tag_groups.cpp,5852,56,140,bs codes,cinematic_scene_reference_block,,h,437,536870912,000000001B949070,30402360,30438816
tag_files\tag_groups.cpp,5852,272,356,bs codes,cinematic_struct_definition,,h,438,536870912,000000001B92D2D0,30402632,30439172
tag_files\tag_groups.cpp,5852,80,164,bs codes,scene_object_attachment_block,,h,439,536870912,000000001B940100,30402712,30439336
tag_files\tag_groups.cpp,5852,176,260,bs codes,cinematic_scene_object_block,,h,440,536870912,000000001B956190,30402888,30439596
tag_files\tag_groups.cpp,5852,72,156,bs codes,cinematic_shot_lighting_block,,h,441,536870912,000000001B940520,30402960,30439752
tag_files\tag_groups.cpp,5852,32,116,bs codes,cinematic_shot_clip_subject_block,,h,442,536870912,000000001B945BE0,30402992,30439868
tag_files\tag_groups.cpp,5852,112,196,bs codes,cinematic_shot_clip_block,,h,443,536870912,000000001B952840,30403104,30440064
tag_files\tag_groups.cpp,5852,96,180,bs codes,cinematic_shot_dialogue_block,,h,444,536870912,000000001B958D90,30403200,30440244
tag_files\tag_groups.cpp,5852,72,156,bs codes,cinematic_shot_music_block,,h,445,536870912,000000001B9407E0,30403272,30440400
tag_files\tag_groups.cpp,5852,80,164,bs codes,cinematic_shot_effect_block,,h,446,536870912,000000001B940F70,30403352,30440564
tag_files\tag_groups.cpp,5852,56,140,bs codes,cinematic_shot_object_function_keyframe_block,,h,447,536870912,000000001B94A1F0,30403408,30440704
tag_files\tag_groups.cpp,5852,64,148,bs codes,cinematic_shot_object_function_block,,h,448,536870912,000000001B94A290,30403472,30440852
tag_files\tag_groups.cpp,5852,64,148,bs codes,cinematic_shot_cortana_effects_block,,h,449,536870912,000000001B94A3D0,30403536,30441000
tag_files\tag_groups.cpp,5852,48,132,bs codes,cinematic_shot_custom_script_block,,h,450,536870912,000000001B9550A0,30403584,30441132
tag_files\tag_groups.cpp,5852,160,244,bs codes,camera_frame_struct,,h,451,536870912,000000001B94B1A0,30403744,30441376
tag_files\tag_groups.cpp,5852,40,124,bs codes,cinematic_shot_frame_block,,h,452,536870912,000000001B955400,30403784,30441500
tag_files\tag_groups.cpp,5852,304,388,bs codes,cinematic_shot_block,,h,453,536870912,000000001B95A6B0,30404088,30441888
tag_files\tag_groups.cpp,5852,48,132,bs codes,cinematic_extra_camera_frame_block,,h,454,536870912,000000001B953900,30404136,30442020
tag_files\tag_groups.cpp,5852,48,132,bs codes,cinematic_extra_camera_shot_block,,h,455,536870912,000000001B955130,30404184,30442152
tag_files\tag_groups.cpp,5852,64,148,bs codes,cinematic_shot_extra_camera_block,,h,456,536870912,000000001B94A470,30404248,30442300
tag_files\tag_groups.cpp,5852,168,252,bs codes,cinematic_scene_struct_definition,,h,457,536870912,000000001B957180,30404416,30442552
tag_files\tag_groups.cpp,5852,40,124,bs codes,scenario_cluster_acoustics_block_struct,,h,458,536870912,000000001B9540E0,30404456,30442676
tag_files\tag_groups.cpp,5852,40,124,bs codes,scenario_cluster_background_sounds_block,,h,459,536870912,000000001B954B00,30404496,30442800
tag_files\tag_groups.cpp,5852,40,124,bs codes,scenario_cluster_sound_environments_block,,h,460,536870912,000000001B954B90,30404536,30442924
tag_files\tag_groups.cpp,5852,48,132,bs codes,scenario_cluster_points_block,,h,461,536870912,000000001B954290,30404584,30443056
tag_files\tag_groups.cpp,5852,40,124,bs codes,scenario_cluster_weather_properties_block,,h,462,536870912,000000001B955490,30404624,30443180
tag_files\tag_groups.cpp,5852,40,124,bs codes,scenario_cluster_atmosphere_properties_block,,h,463,536870912,000000001B953FC0,30404664,30443304
tag_files\tag_groups.cpp,5852,40,124,bs codes,scenario_cluster_camera_fx_properties_block,,h,464,536870912,000000001B953990,30404704,30443428
tag_files\tag_groups.cpp,5852,232,316,bs codes,scenario_cluster_data_block,,h,465,536870912,000000001B95A840,30404936,30443744
tag_files\tag_groups.cpp,5852,72,156,bs codes,scenario_acoustics_environment_definition,,h,466,536870912,000000001B9412E0,30405008,30443900
tag_files\tag_groups.cpp,5852,136,220,bs codes,scenario_acoustics_ambience_definition,,h,467,536870912,000000001B900A50,30405144,30444120
tag_files\tag_groups.cpp,5852,64,148,bs codes,scenario_acoustics_palette_block_definition_struct,,h,468,536870912,000000001B95D490,30405208,30444268
tag_files\tag_groups.cpp,5852,160,244,bs codes,scenario_acoustics_ambience_palette_block,,h,469,536870912,000000001B94B2A0,30405368,30444512
tag_files\tag_groups.cpp,5852,88,172,bs codes,scenario_acoustics_environment_palette_block,,h,470,536870912,000000001B95A110,30405456,30444684
tag_files\tag_groups.cpp,5852,112,196,bs codes,structure_bsp_weather_palette_block,,h,471,536870912,000000001B951C10,30405568,30444880
tag_files\tag_groups.cpp,5852,48,132,bs codes,structure_bsp_atmosphere_palette_block,,h,472,536870912,000000001B954440,30405616,30445012
tag_files\tag_groups.cpp,5852,128,212,bs codes,structure_bsp_camera_fx_palette_block,,h,473,536870912,000000001B943F00,30405744,30445224
tag_files\tag_groups.cpp,5852,168,252,bs codes,scenario_cluster_data_resource_struct_definition,,h,474,536870912,000000001B955E60,30405912,30445476
tag_files\tag_groups.cpp,5852,40,124,bs codes,collision_sphere_block,,h,475,536870912,000000001B953A20,30405952,30445600
tag_files\tag_groups.cpp,5852,88,172,bs codes,cloth_properties,,h,476,536870912,000000001B958790,30406040,30445772
tag_files\tag_groups.cpp,5852,64,148,bs codes,cloth_vertices_block,,h,477,536870912,000000001B95E6B0,30406104,30445920
tag_files\tag_groups.cpp,5852,32,116,bs codes,cloth_indices_block,,h,478,536870912,000000001B9461E0,30406136,30446036
tag_files\tag_groups.cpp,5852,48,132,bs codes,cloth_links_block,,h,479,536870912,000000001B953750,30406184,30446168
tag_files\tag_groups.cpp,5852,248,332,bs codes,cloth_struct_definition,,h,480,536870912,000000001B95EA00,30406432,30446500
tag_files\tag_groups.cpp,5852,40,124,bs codes,compute_entry_point_block,,h,481,536870912,000000001B953AB0,30406472,30446624
tag_files\tag_groups.cpp,5852,56,140,bs codes,rasterizer_constant_block,,h,482,536870912,000000001B95E110,30406528,30446764
tag_files\tag_groups.cpp,5852,80,164,bs codes,global_rasterizer_constant_table_struct,,h,483,536870912,000000001B9419C0,30406608,30446928
tag_files\tag_groups.cpp,5852,200,284,bs codes,rasterizer_compiled_shader_struct,,h,484,536870912,000000001B8FBBB0,30406808,30447212
tag_files\tag_groups.cpp,5852,48,132,bs codes,compiled_compute_shader_block,,h,485,536870912,000000001B9545F0,30406856,30447344
tag_files\tag_groups.cpp,5852,88,172,bs codes,compute_shader_block_struct,,h,486,536870912,000000001B95A350,30406944,30447516
tag_files\tag_groups.cpp,5852,96,180,bs codes,contrail_property_scalar,,h,487,536870912,000000001B959BD0,30407040,30447696
tag_files\tag_groups.cpp,5852,144,228,bs codes,contrail_property_real_vector3d,,h,488,536870912,000000001B960190,30407184,30447924
tag_files\tag_groups.cpp,5852,128,212,bs codes,contrail_property_real_point2d,,h,489,536870912,000000001B943020,30407312,30448136
tag_files\tag_groups.cpp,5852,96,180,bs codes,contrail_property_color,,h,490,536870912,000000001B959C90,30407408,30448316
tag_files\tag_groups.cpp,5852,408,492,bs codes,contrail_definition_block,,h,491,536870912,0000000000FDD270,30407816,30448808
tag_files\tag_groups.cpp,5852,48,132,bs codes,contrail_system_struct_definition,,h,492,536870912,000000001B954950,30407864,30448940
tag_files\tag_groups.cpp,5852,32,116,bs codes,collision_model_material_block,,h,493,536870912,000000001B944F60,30407896,30449056
tag_files\tag_groups.cpp,5852,32,116,bs codes,bsp3d_nodes_block_struct,,h,494,536870912,000000001B946D60,30407928,30449172
tag_files\tag_groups.cpp,5852,32,116,bs codes,old_bsp3d_nodes_struct,,h,495,536870912,000000001B946060,30407960,30449288
tag_files\tag_groups.cpp,5852,56,140,bs codes,planes_block,,h,496,536870912,000000001B95E890,30408016,30449428
tag_files\tag_groups.cpp,5852,56,140,bs codes,collision_leaf_struct,,h,497,536870912,000000001B95E610,30408072,30449568
tag_files\tag_groups.cpp,5852,56,140,bs codes,old_collision_leaf_struct,,h,498,536870912,000000001B95D670,30408128,30449708
tag_files\tag_groups.cpp,5852,40,124,bs codes,bsp2d_references_block,,h,499,536870912,000000001B9549E0,30408168,30449832
tag_files\tag_groups.cpp,5852,64,148,bs codes,bsp2d_nodes_block,,h,500,536870912,000000001B95E750,30408232,30449980
tag_files\tag_groups.cpp,5852,80,164,bs codes,surfaces_block,,h,501,536870912,000000001B941BD0,30408312,30450144
tag_files\tag_groups.cpp,5852,72,156,bs codes,edges_block,,h,502,536870912,000000001B9401B0,30408384,30450300
tag_files\tag_groups.cpp,5852,64,148,bs codes,vertices_block,,h,503,536870912,000000001B95DC10,30408448,30450448
tag_files\tag_groups.cpp,5852,216,300,bs codes,global_collision_bsp_struct,,h,504,536870912,000000001B9202D0,30408664,30450748
tag_files\tag_groups.cpp,5852,56,140,bs codes,collision_model_bsp_block,,h,505,536870912,000000001B95D710,30408720,30450888
tag_files\tag_groups.cpp,5852,64,148,bs codes,havok_shape_collection_struct,,h,506,536870912,000000001B95D990,30408784,30451036
tag_files\tag_groups.cpp,5852,224,308,bs codes,collision_bsp_physics_block,,h,507,536870912,000000001B920690,30409008,30451344
tag_files\tag_groups.cpp,5852,32,116,bs codes,mopp_code_data_definition_block,,h,508,536870912,000000001B9459E0,30409040,30451460
tag_files\tag_groups.cpp,5852,144,228,bs codes,mopp_code_definition_block,,h,509,536870912,000000001B960550,30409184,30451688
tag_files\tag_groups.cpp,5852,104,188,bs codes,collision_model_permutation_block,,h,510,536870912,000000001B951A70,30409288,30451876
tag_files\tag_groups.cpp,5852,96,180,bs codes,collision_model_permutation_fields_v0,,h,511,536870912,000000001B959D50,30409384,30452056
tag_files\tag_groups.cpp,5852,56,140,bs codes,collision_model_region_block,,h,512,536870912,000000001B95D030,30409440,30452196
tag_files\tag_groups.cpp,5852,72,156,bs codes,collision_model_pathfinding_sphere_block,,h,513,536870912,000000001B9415A0,30409512,30452352
tag_files\tag_groups.cpp,5852,64,148,bs codes,collision_model_node_block,,h,514,536870912,000000001B95D530,30409576,30452500
tag_files\tag_groups.cpp,5852,72,156,bs codes,collision_model_node_fields_v0,,h,515,536870912,000000001B941C80,30409648,30452656
tag_files\tag_groups.cpp,5852,160,244,bs codes,collision_model_struct_definition,,h,516,536870912,000000001B94CAA0,30409808,30452900
tag_files\tag_groups.cpp,5852,32,116,bs codes,OLD_global_damage_resistance_struct,,h,517,536870912,000000001B945D60,30409840,30453016
tag_files\tag_groups.cpp,5852,168,252,bs codes,collision_model_fields_v0,,h,518,536870912,000000001B956F60,30410008,30453268
tag_files\tag_groups.cpp,5852,64,148,bs codes,color_block,,h,519,536870912,000000001B95DE90,30410072,30453416
tag_files\tag_groups.cpp,5852,48,132,bs codes,color_table_struct_definition,,h,520,536870912,000000001B953B40,30410120,30453548
tag_files\tag_groups.cpp,5852,216,300,bs codes,creature_struct_definition,,h,521,536870912,000000001B9207D0,30410336,30453848
tag_files\tag_groups.cpp,5852,728,812,bs codes,creature_struct_definition,,h,522,536870912,000000001B9619D0,30411064,30454660
tag_files\tag_groups.cpp,5852,64,148,bs codes,cortana_sound_definition_block,,h,523,536870912,000000001B95CC70,30411128,30454808
tag_files\tag_groups.cpp,5852,64,148,bs codes,cortana_script_block,,h,524,536870912,000000001B95CBD0,30411192,30454956
tag_files\tag_groups.cpp,5852,48,132,bs codes,cortana_keyframe_2d_block,,h,525,536870912,000000001B953BD0,30411240,30455088
tag_files\tag_groups.cpp,5852,64,148,bs codes,cortana_animation_2d_block,,h,526,536870912,000000001B95E7F0,30411304,30455236
tag_files\tag_groups.cpp,5852,120,204,bs codes,cortana_effect_2d_block,,h,527,536870912,000000001B943100,30411424,30455440
tag_files\tag_groups.cpp,5852,56,140,bs codes,cortana_keyframe_3d_block,,h,528,536870912,000000001B95C9F0,30411480,30455580
tag_files\tag_groups.cpp,5852,64,148,bs codes,cortana_animation_3d_block,,h,529,536870912,000000001B95DF30,30411544,30455728
tag_files\tag_groups.cpp,5852,128,212,bs codes,cortana_effect_3d_block,,h,530,536870912,000000001B942060,30411672,30455940
tag_files\tag_groups.cpp,5852,168,252,bs codes,cortana_background_effect_params_block,,h,531,536870912,000000001B957290,30411840,30456192
tag_files\tag_groups.cpp,5852,120,204,bs codes,cortana_texcam_effect_params_block,,h,532,536870912,000000001B942F40,30411960,30456396
tag_files\tag_groups.cpp,5852,32,116,bs codes,cortana_widget_block,,h,533,536870912,000000001B9453E0,30411992,30456512
tag_files\tag_groups.cpp,5852,96,180,bs codes,cortana_composite_effect_params_block,,h,534,536870912,000000001B958850,30412088,30456692
tag_files\tag_groups.cpp,5852,232,316,bs codes,cortana_effect_definition_struct_definition,,h,535,536870912,000000001B962000,30412320,30457008
tag_files\tag_groups.cpp,5852,352,436,bs codes,device_struct_definition,,h,536,536870912,000000001B962D20,30412672,30457444
tag_files\tag_groups.cpp,5852,336,420,bs codes,device_struct_definition,,h,537,536870912,000000001B962EE0,30413008,30457864
tag_files\tag_groups.cpp,5852,168,252,bs codes,device_control_struct_definition,,h,538,536870912,000000001B957070,30413176,30458116
tag_files\tag_groups.cpp,5852,992,1076,bs codes,device_control_struct_definition,,h,539,536870912,000000001B963090,30414168,30459192
tag_files\tag_groups.cpp,5852,64,148,bs codes,scenario_cubemap_block,,h,540,536870912,000000001B95D5D0,30414232,30459340
tag_files\tag_groups.cpp,5852,48,132,bs codes,scenario_cubemap_resource_struct_definition,,h,541,536870912,000000001B953D80,30414280,30459472
tag_files\tag_groups.cpp,5852,152,236,bs codes,decorator_brush_struct,,h,542,536870912,000000001B94C4A0,30414432,30459708
tag_files\tag_groups.cpp,5852,160,244,bs codes,decorator_palette,,h,543,536870912,000000001B94C8A0,30414592,30459952
tag_files\tag_groups.cpp,5852,240,324,bs codes,global_decorator_placement_block,,h,544,536870912,000000001B9622A0,30414832,30460276
tag_files\tag_groups.cpp,5852,80,164,bs codes,decorator_scenario_set_block,,h,545,536870912,000000001B941E90,30414912,30460440
tag_files\tag_groups.cpp,5852,200,284,bs codes,scenario_decorator_block,,h,546,536870912,000000001B8FC530,30415112,30460724
tag_files\tag_groups.cpp,5852,88,172,bs codes,scenario_decorators_resource_struct_definition,,h,547,536870912,000000001B9592D0,30415200,30460896
tag_files\tag_groups.cpp,5852,32,116,bs codes,decorator_set_instance_name_block,,h,548,536870912,000000001B945EE0,30415232,30461012
tag_files\tag_groups.cpp,5852,208,292,bs codes,global_decorator_type_struct,,h,549,536870912,000000001B8FB6F0,30415440,30461304
tag_files\tag_groups.cpp,5852,304,388,bs codes,decorator_set_block,,h,550,536870912,000000001B9634D0,30415744,30461692
tag_files\tag_groups.cpp,5852,56,140,bs codes,scenario_decal_palette_block,,h,551,536870912,000000001B95D350,30415800,30461832
tag_files\tag_groups.cpp,5852,112,196,bs codes,scenario_decals_block,,h,552,536870912,000000001B951CE0,30415912,30462028
tag_files\tag_groups.cpp,5852,112,196,bs codes,scenario_decals_resource_struct_definition,,h,553,536870912,000000001B951B40,30416024,30462224
tag_files\tag_groups.cpp,5852,168,252,bs codes,shader_decal_struct_definition,,h,554,536870912,000000001B9562A0,30416192,30462476
tag_files\tag_groups.cpp,5852,144,228,bs codes,decal_definition_block,,h,555,536870912,000000001B961360,30416336,30462704
tag_files\tag_groups.cpp,5852,96,180,bs codes,decal_system_struct_definition,,h,556,536870912,000000001B959B10,30416432,30462884
tag_files\tag_groups.cpp,5852,328,412,bs codes,cellular_automata_struct_definition,,h,557,536870912,000000001B963660,30416760,30463296
tag_files\tag_groups.cpp,5852,48,132,bs codes,device_group_block,,h,558,536870912,000000001B9544D0,30416808,30463428
tag_files\tag_groups.cpp,5852,72,156,bs codes,scenario_machine_struct_v3,,h,559,536870912,000000001B940050,30416880,30463584
tag_files\tag_groups.cpp,5852,104,188,bs codes,scenario_machine_block,,h,560,536870912,000000001B952290,30416984,30463772
tag_files\tag_groups.cpp,5852,56,140,bs codes,scenario_machine_struct_v2,,h,561,536870912,000000001B95CA90,30417040,30463912
tag_files\tag_groups.cpp,5852,88,172,bs codes,scenario_machine_fields_v2,,h,562,536870912,000000001B958910,30417128,30464084
tag_files\tag_groups.cpp,5852,88,172,bs codes,scenario_machine_fields_v2,,h,563,536870912,000000001B959390,30417216,30464256
tag_files\tag_groups.cpp,5852,48,132,bs codes,old_scenario_device_struct,,h,564,536870912,000000001B953630,30417264,30464388
tag_files\tag_groups.cpp,5852,152,236,bs codes,scenario_machine_fields_v1,,h,565,536870912,000000001B94C2A0,30417416,30464624
tag_files\tag_groups.cpp,5852,56,140,bs codes,scenario_machine_palette_block,,h,566,536870912,000000001B95D7B0,30417472,30464764
tag_files\tag_groups.cpp,5852,32,116,bs codes,scenario_terminal_struct,,h,567,536870912,000000001B945AE0,30417504,30464880
tag_files\tag_groups.cpp,5852,104,188,bs codes,scenario_terminal_block,,h,568,536870912,000000001B953130,30417608,30465068
tag_files\tag_groups.cpp,5852,56,140,bs codes,scenario_terminal_palette_block,,h,569,536870912,000000001B95E1B0,30417664,30465208
tag_files\tag_groups.cpp,5852,32,116,bs codes,scenario_control_struct,,h,570,536870912,000000001B946960,30417696,30465324
tag_files\tag_groups.cpp,5852,104,188,bs codes,scenario_control_block,,h,571,536870912,000000001B952D20,30417800,30465512
tag_files\tag_groups.cpp,5852,104,188,bs codes,scenario_control_fields_v2,,h,572,536870912,000000001B952360,30417904,30465700
tag_files\tag_groups.cpp,5852,168,252,bs codes,scenario_control_fields_v1,,h,573,536870912,000000001B9575C0,30418072,30465952
tag_files\tag_groups.cpp,5852,56,140,bs codes,scenario_control_palette_block,,h,574,536870912,000000001B95D170,30418128,30466092
tag_files\tag_groups.cpp,5852,328,412,bs codes,scenario_devices_resource_struct_definition,,h,575,536870912,000000001B963810,30418456,30466504
tag_files\tag_groups.cpp,5852,168,252,bs codes,detail_object_type_block,,h,576,536870912,000000001B9563B0,30418624,30466756
tag_files\tag_groups.cpp,5852,120,204,bs codes,detail_object_collection_struct_definition,,h,577,536870912,000000001B942680,30418744,30466960
tag_files\tag_groups.cpp,5852,32,116,bs codes,rasterizer_cache_file_globals_struct_definition,,h,578,536870912,000000001B946DE0,30418776,30467076
tag_files\tag_groups.cpp,5852,104,188,bs codes,damage_response_screen_flash_struct,,h,579,536870912,000000001B951E80,30418880,30467264
tag_files\tag_groups.cpp,5852,72,156,bs codes,damage_response_motion_blur_struct,,h,580,536870912,000000001B9405D0,30418952,30467420
tag_files\tag_groups.cpp,5852,104,188,bs codes,damage_response_directional_flash_struct,,h,581,536870912,000000001B951660,30419056,30467608
tag_files\tag_groups.cpp,5852,48,132,bs codes,damage_response_rumble_frequency_struct,,h,582,536870912,000000001B953C60,30419104,30467740
tag_files\tag_groups.cpp,5852,56,140,bs codes,damage_response_rumble_struct,,h,583,536870912,000000001B95E250,30419160,30467880
tag_files\tag_groups.cpp,5852,80,164,bs codes,damage_response_camera_impulse_struct,,h,584,536870912,000000001B940680,30419240,30468044
tag_files\tag_groups.cpp,5852,96,180,bs codes,damage_response_camera_shake_struct,,h,585,536870912,000000001B959510,30419336,30468224
tag_files\tag_groups.cpp,5852,136,220,bs codes,damage_response_class_block,,h,586,536870912,000000001B960910,30419472,30468444
tag_files\tag_groups.cpp,5852,48,132,bs codes,damage_response_definition_struct_definition,,h,587,536870912,000000001B9536C0,30419520,30468576
tag_files\tag_groups.cpp,5852,40,124,bs codes,integer_data_nugget_block,,h,588,536870912,000000001B954F80,30419560,30468700
tag_files\tag_groups.cpp,5852,40,124,bs codes,string_data_nugget_block,,h,589,536870912,000000001B954710,30419600,30468824
tag_files\tag_groups.cpp,5852,40,124,bs codes,string_id_data_nugget_block,,h,590,536870912,000000001B954A70,30419640,30468948
tag_files\tag_groups.cpp,5852,104,188,bs codes,datasource_element_block,,h,591,536870912,000000001B952910,30419744,30469136
tag_files\tag_groups.cpp,5852,64,148,bs codes,gui_datasource_definition_struct_definition,,h,592,536870912,000000001B95D850,30419808,30469284
tag_files\tag_groups.cpp,5852,56,140,bs codes,effect_locations_block,,h,593,536870912,000000001B95D210,30419864,30469424
tag_files\tag_groups.cpp,5852,248,332,bs codes,effect_part_block,,h,594,536870912,000000001B95EE20,30420112,30469756
tag_files\tag_groups.cpp,5852,80,164,bs codes,effect_accelerations_block,,h,595,536870912,000000001B940890,30420192,30469920
tag_files\tag_groups.cpp,5852,168,252,bs codes,effect_event_block,,h,596,536870912,000000001B956B20,30420360,30470172
tag_files\tag_groups.cpp,5852,56,140,bs codes,effect_conical_distribution_block,,h,597,536870912,000000001B95D8F0,30420416,30470312
tag_files\tag_groups.cpp,5852,264,348,bs codes,effect_struct_definition,,h,598,536870912,000000001B92E2A0,30420680,30470660
tag_files\tag_groups.cpp,5852,56,140,bs codes,effect_component_holdback_block,,h,599,536870912,000000001B95DFD0,30420736,30470800
tag_files\tag_groups.cpp,5852,64,148,bs codes,effect_component_holdbacks_block,,h,600,536870912,000000001B95CD10,30420800,30470948
tag_files\tag_groups.cpp,5852,48,132,bs codes,effect_globals_struct_definition,,h,601,536870912,000000001B9537E0,30420848,30471080
tag_files\tag_groups.cpp,5852,40,124,bs codes,effect_scenery_struct_definition,,h,602,536870912,000000001B954DD0,30420888,30471204
tag_files\tag_groups.cpp,5852,552,636,bs codes,effect_scenery_struct_definition,,h,603,536870912,000000001B9639C0,30421440,30471840
tag_files\tag_groups.cpp,5852,184,268,bs codes,rasterizer_screen_effect_texcoord_generation_advanced_control_block,,h,604,536870912,000000001B93CFA0,30421624,30472108
tag_files\tag_groups.cpp,5852,96,180,bs codes,rasterizer_screen_effect_convolution_block,,h,605,536870912,000000001B95A290,30421720,30472288
tag_files\tag_groups.cpp,5852,224,308,bs codes,rasterizer_screen_effect_pass_reference_block,,h,606,536870912,000000001B920410,30421944,30472596
tag_files\tag_groups.cpp,5852,64,148,bs codes,screen_effect_struct_definition,,h,607,536870912,000000001B95E070,30422008,30472744
tag_files\tag_groups.cpp,5852,336,420,bs codes,item_struct_definition,,h,608,536870912,000000001B963C50,30422344,30473164
tag_files\tag_groups.cpp,5852,320,404,bs codes,item_struct_definition,,h,609,536870912,000000001B963E00,30422664,30473568
tag_files\tag_groups.cpp,5852,144,228,bs codes,equipment_type_super_shield_block,,h,610,536870912,000000001B960A00,30422808,30473796
tag_files\tag_groups.cpp,5852,32,116,bs codes,equipment_type_multiplayer_powerup_block,,h,611,536870912,000000001B9469E0,30422840,30473912
tag_files\tag_groups.cpp,5852,136,220,bs codes,equipment_type_spawner_block,,h,612,536870912,000000001B960460,30422976,30474132
tag_files\tag_groups.cpp,5852,120,204,bs codes,equipment_type_proximity_mine_block,,h,613,536870912,000000001B942CA0,30423096,30474336
tag_files\tag_groups.cpp,5852,56,140,bs codes,equipment_type_motion_tracker_noise_block,,h,614,536870912,000000001B95CF90,30423152,30474476
tag_files\tag_groups.cpp,5852,32,116,bs codes,equipment_type_showme_block,,h,615,536870912,000000001B946A60,30423184,30474592
tag_files\tag_groups.cpp,5852,40,124,bs codes,equipment_type_invisibility_mode_block,,h,616,536870912,000000001B954320,30423224,30474716
tag_files\tag_groups.cpp,5852,152,236,bs codes,equipment_type_invincibility_block,,h,617,536870912,000000001B94C3A0,30423376,30474952
tag_files\tag_groups.cpp,5852,32,116,bs codes,equipment_type_treeoflife_block,,h,618,536870912,000000001B945A60,30423408,30475068
tag_files\tag_groups.cpp,5852,40,124,bs codes,equipment_type_health_pack_block,,h,619,536870912,000000001B9551C0,30423448,30475192
tag_files\tag_groups.cpp,5852,496,580,bs codes,equipment_group,,h,620,536870912,000000001B963FA0,30423944,30475772
tag_files\tag_groups.cpp,5852,1304,1388,bs codes,equipment_group,,h,621,536870912,000000001B9641F0,30425248,30477160
tag_files\tag_groups.cpp,5852,896,980,bs codes,equipment_definition_fields_v1,,h,622,536870912,000000001B964770,30426144,30478140
tag_files\tag_groups.cpp,5852,208,292,bs codes,flock_struct_definition,,h,623,536870912,000000001B8FB950,30426352,30478432
tag_files\tag_groups.cpp,5852,56,140,bs codes,fluid_dynamics_squirter_block,,h,624,536870912,000000001B95E2F0,30426408,30478572
tag_files\tag_groups.cpp,5852,64,148,bs codes,fluid_dynamics_inflow_block,,h,625,536870912,000000001B95E390,30426472,30478720
tag_files\tag_groups.cpp,5852,40,124,bs codes,fluid_dynamics_outflow_block,,h,626,536870912,000000001B954170,30426512,30478844
tag_files\tag_groups.cpp,5852,40,124,bs codes,fluid_dynamics_obstacle_block,,h,627,536870912,000000001B953CF0,30426552,30478968
tag_files\tag_groups.cpp,5852,56,140,bs codes,g_single_scalar_function_evaluation_struct,,h,628,536870912,000000001B95CDB0,30426608,30479108
tag_files\tag_groups.cpp,5852,384,468,bs codes,fluid_dynamics_struct_definition,,h,629,536870912,000000001B911F10,30426992,30479576
tag_files\tag_groups.cpp,5852,128,212,bs codes,planar_fog_patchy_fog_block,,h,630,536870912,000000001B942760,30427120,30479788
tag_files\tag_groups.cpp,5852,304,388,bs codes,planar_fog_struct_definition,,h,631,536870912,000000001B964B50,30427424,30480176
tag_files\tag_groups.cpp,5852,128,212,bs codes,old_material_effect_material_block,,h,632,536870912,000000001B9432C0,30427552,30480388
tag_files\tag_groups.cpp,5852,120,204,bs codes,material_effect_material_block,,h,633,536870912,000000001B942220,30427672,30480592
tag_files\tag_groups.cpp,5852,88,172,bs codes,material_effect_material_fields_v1,,h,634,536870912,000000001B9589D0,30427760,30480764
tag_files\tag_groups.cpp,5852,96,180,bs codes,material_effect_block_v2,,h,635,536870912,000000001B959990,30427856,30480944
tag_files\tag_groups.cpp,5852,48,132,bs codes,material_effects_block_struct,,h,636,536870912,000000001B954050,30427904,30481076
tag_files\tag_groups.cpp,5852,208,292,bs codes,patchy_fog_struct_definition,,h,637,536870912,000000001B8FC790,30428112,30481368
tag_files\tag_groups.cpp,5852,104,188,bs codes,fragment_struct_definition,,h,638,536870912,000000001B951730,30428216,30481556
tag_files\tag_groups.cpp,5852,208,292,bs codes,giant_buckle_parameters_block,,h,639,536870912,000000001B8FAB10,30428424,30481848
tag_files\tag_groups.cpp,5852,120,204,bs codes,giant_struct_definition,,h,640,536870912,000000001B942140,30428544,30482052
tag_files\tag_groups.cpp,5852,1176,1260,bs codes,giant_struct_definition,,h,641,536870912,000000001B964CE0,30429720,30483312
tag_files\tag_groups.cpp,5852,32,116,bs codes,global_shader_option_dependency,,h,642,536870912,000000001B945560,30429752,30483428
tag_files\tag_groups.cpp,5852,56,140,bs codes,global_shader_category_dependency,,h,643,536870912,000000001B95E430,30429808,30483568
tag_files\tag_groups.cpp,5852,64,148,bs codes,global_shader_entry_point_block,,h,644,536870912,000000001B95D2B0,30429872,30483716
tag_files\tag_groups.cpp,5852,48,132,bs codes,compiled_pixel_shader_block,,h,645,536870912,000000001B955010,30429920,30483848
tag_files\tag_groups.cpp,5852,80,164,bs codes,global_pixel_shader_block_struct,,h,646,536870912,000000001B940730,30430000,30484012
tag_files\tag_groups.cpp,5852,48,132,bs codes,global_vertex_shader_vertex_types_block,,h,647,536870912,000000001B953E10,30430048,30484144
tag_files\tag_groups.cpp,5852,48,132,bs codes,compiled_vertex_shader_block,,h,648,536870912,000000001B954C20,30430096,30484276
tag_files\tag_groups.cpp,5852,80,164,bs codes,global_vertex_shader_block_struct,,h,649,536870912,000000001B940B50,30430176,30484440
tag_files\tag_groups.cpp,5852,144,228,bs codes,variant_option_block,,h,650,536870912,000000001B961450,30430320,30484668
tag_files\tag_groups.cpp,5852,64,148,bs codes,variant_setting_edit_reference_block,,h,651,536870912,000000001B95DA30,30430384,30484816
tag_files\tag_groups.cpp,5852,56,140,bs codes,multiplayer_variant_settings_interface_definition_struct_definition,,h,652,536870912,000000001B95DAD0,30430440,30484956
tag_files\tag_groups.cpp,5852,160,244,bs codes,list_item_widget_block,,h,653,536870912,000000001B94B8A0,30430600,30485200
tag_files\tag_groups.cpp,5852,320,404,bs codes,list_widget_block,,h,654,536870912,000000001B9671F0,30430920,30485604
tag_files\tag_groups.cpp,5852,40,124,bs codes,keyframe_transition_function_block,,h,655,536870912,000000001B9547A0,30430960,30485728
tag_files\tag_groups.cpp,5852,168,252,bs codes,model_widget_camera_settings_block,,h,656,536870912,000000001B955D50,30431128,30485980
tag_files\tag_groups.cpp,5852,208,292,bs codes,model_widget_block,,h,657,536870912,000000001B8FAC40,30431336,30486272
tag_files\tag_groups.cpp,5852,248,332,bs codes,gui_group_widget_definition_struct_definition,,h,658,536870912,000000001B95EF80,30431584,30486604
tag_files\tag_groups.cpp,5852,32,116,bs codes,runtime_region_index_array,,h,659,536870912,000000001B946AE0,30431616,30486720
tag_files\tag_groups.cpp,5852,104,188,bs codes,model_variant_state_block,,h,660,536870912,000000001B952EC0,30431720,30486908
tag_files\tag_groups.cpp,5852,88,172,bs codes,model_variant_permutation_block,,h,661,536870912,000000001B959ED0,30431808,30487080
tag_files\tag_groups.cpp,5852,80,164,bs codes,model_variant_region_block,,h,662,536870912,000000001B940C00,30431888,30487244
tag_files\tag_groups.cpp,5852,80,164,bs codes,model_variant_object_block,,h,663,536870912,000000001B967F90,30431968,30487408
tag_files\tag_groups.cpp,5852,128,212,bs codes,model_variant_block,,h,664,536870912,000000001B942300,30432096,30487620
tag_files\tag_groups.cpp,5852,80,164,bs codes,model_instance_group_member_block,,h,665,536870912,000000001B967750,30432176,30487784
tag_files\tag_groups.cpp,5852,72,156,bs codes,global_model_instance_group_block,,h,666,536870912,000000001B967490,30432248,30487940
tag_files\tag_groups.cpp,5852,88,172,bs codes,model_material_block,,h,667,536870912,000000001B958E50,30432336,30488112
tag_files\tag_groups.cpp,5852,64,148,bs codes,damage_body_parameters_struct,,h,668,536870912,000000001B95CE50,30432400,30488260
tag_files\tag_groups.cpp,5852,168,252,bs codes,damage_shield_parameters_struct,,h,669,536870912,000000001B9567F0,30432568,30488512
tag_files\tag_groups.cpp,5852,56,140,bs codes,instantaneous_response_damage_effect_struct,,h,670,536870912,000000001B95CB30,30432624,30488652
tag_files\tag_groups.cpp,5852,24,108,bs codes,instantaneous_response_damage_effect_fields_v1,,h,671,536870912,000000001B946BE0,30432648,30488760
tag_files\tag_groups.cpp,5852,32,116,bs codes,instantaneous_response_damage_effect_marker_struct,,h,672,536870912,000000001B944EE0,30432680,30488876
tag_files\tag_groups.cpp,5852,24,108,bs codes,instantaneous_response_damage_effect_marker_fields_v1,,h,673,536870912,000000001B944FE0,30432704,30488984
tag_files\tag_groups.cpp,5852,320,404,bs codes,instantaneous_damage_repsonse_block,,h,674,536870912,000000001B9693A0,30433024,30489388
tag_files\tag_groups.cpp,5852,120,204,bs codes,global_damage_section_block,,h,675,536870912,000000001B942840,30433144,30489592
tag_files\tag_groups.cpp,5852,32,116,bs codes,global_damage_nodes_block,,h,676,536870912,000000001B946B60,30433176,30489708
tag_files\tag_groups.cpp,5852,120,204,bs codes,damage_seat_region_setting_block,,h,677,536870912,000000001B9433A0,30433296,30489912
tag_files\tag_groups.cpp,5852,88,172,bs codes,damage_seat_info_block,,h,678,536870912,000000001B958A90,30433384,30490084
tag_files\tag_groups.cpp,5852,72,156,bs codes,damage_constraint_info_block,,h,679,536870912,000000001B9683B0,30433456,30490240
tag_files\tag_groups.cpp,5852,224,308,bs codes,global_damage_info_block,,h,680,536870912,000000001B91FB50,30433680,30490548
tag_files\tag_groups.cpp,5852,464,548,bs codes,global_damage_info_block_fields_v1,,h,681,536870912,000000001B969540,30434144,30491096
tag_files\tag_groups.cpp,5852,40,124,bs codes,model_target_lock_on_data_struct,,h,682,536870912,000000001B953EA0,30434184,30491220
tag_files\tag_groups.cpp,5852,96,180,bs codes,model_target_block,,h,683,536870912,000000001B958FD0,30434280,30491400
tag_files\tag_groups.cpp,5852,64,148,bs codes,model_permutation_block,,h,684,536870912,000000001B95D3F0,30434344,30491548
tag_files\tag_groups.cpp,5852,80,164,bs codes,model_region_block,,h,685,536870912,000000001B968E00,30434424,30491712
tag_files\tag_groups.cpp,5852,224,308,bs codes,model_node_block,,h,686,536870912,000000001B96AE40,30434648,30492020
tag_files\tag_groups.cpp,5852,72,156,bs codes,model_object_data_block,,h,687,536870912,000000001B967800,30434720,30492176
tag_files\tag_groups.cpp,5852,32,116,bs codes,g_node_flag_storage_array,,h,688,536870912,000000001B945460,30434752,30492292
tag_files\tag_groups.cpp,5852,104,188,bs codes,global_scenario_load_parameters_block,,h,689,536870912,000000001B9532D0,30434856,30492480
tag_files\tag_groups.cpp,5852,40,124,bs codes,model_self_shadow_region_cast_override_block,,h,690,536870912,000000001B954680,30434896,30492604
tag_files\tag_groups.cpp,5852,40,124,bs codes,model_self_shadow_region_receive_override_block,,h,691,536870912,000000001B953F30,30434936,30492728
tag_files\tag_groups.cpp,5852,64,148,bs codes,model_occlusion_sphere_block,,h,692,536870912,000000001B95DB70,30435000,30492876
tag_files\tag_groups.cpp,5852,776,860,bs codes,model_block_struct,,h,693,536870912,000000001B96B780,30435776,30493736
tag_files\tag_groups.cpp,5852,64,148,bs codes,hlsl_include_struct_definition,,h,694,536870912,000000001B95DCB0,30435840,30493884
tag_files\tag_groups.cpp,5852,56,140,bs codes,hs_references_block,,h,695,536870912,000000001B95CEF0,30435896,30494024
tag_files\tag_groups.cpp,5852,104,188,bs codes,hs_source_files_block,,h,696,536870912,000000001B9525D0,30436000,30494212
tag_files\tag_groups.cpp,5852,112,196,bs codes,animation_graph_node_block,,h,697,536870912,000000001B9521C0,30436112,30494408
tag_files\tag_groups.cpp,5852,112,196,bs codes,animation_graph_node_v0_fields,,h,698,536870912,000000001B9533A0,30436224,30494604
tag_files\tag_groups.cpp,5852,72,156,bs codes,animation_graph_sound_reference_block,,h,699,536870912,000000001B968040,30436296,30494760
tag_files\tag_groups.cpp,5852,72,156,bs codes,animation_graph_effect_reference_block,,h,700,536870912,000000001B9673E0,30436368,30494916
tag_files\tag_groups.cpp,5852,88,172,bs codes,animation_aiming_screen_struct,,h,701,536870912,000000001B958CD0,30436456,30495088
tag_files\tag_groups.cpp,5852,48,132,bs codes,animation_blend_screen_block,,h,702,536870912,000000001B955250,30436504,30495220
tag_files\tag_groups.cpp,5852,88,172,bs codes,foot_tracking_member_block,,h,703,536870912,000000001B958F10,30436592,30495392
tag_files\tag_groups.cpp,5852,40,124,bs codes,animation_frame_event_struct,,h,704,536870912,000000001B9548C0,30436632,30495516
tag_files\tag_groups.cpp,5852,40,124,bs codes,old_animation_frame_event_struct,,h,705,536870912,000000001B954560,30436672,30495640
tag_files\tag_groups.cpp,5852,48,132,bs codes,animation_sound_event_block,,h,706,536870912,000000001B954E60,30436720,30495772
tag_files\tag_groups.cpp,5852,48,132,bs codes,animation_effect_event_block,,h,707,536870912,000000001B954830,30436768,30495904
tag_files\tag_groups.cpp,5852,40,124,bs codes,s_effect_event_v1_fields,,h,708,536870912,000000001B954D40,30436808,30496028
tag_files\tag_groups.cpp,5852,48,132,bs codes,s_effect_event_v0_fields,,h,709,536870912,000000001B954CB0,30436856,30496160
tag_files\tag_groups.cpp,5852,40,124,bs codes,animation_dialogue_event_block,,h,710,536870912,000000001B954EF0,30436896,30496284
tag_files\tag_groups.cpp,5852,88,172,bs codes,quantized_orientation_struct,,h,711,536870912,000000001B958610,30436984,30496456
tag_files\tag_groups.cpp,5852,56,140,bs codes,object_space_node_data_block,,h,712,536870912,000000001B95E4D0,30437040,30496596
tag_files\tag_groups.cpp,5852,80,164,bs codes,foot_lock_cycle_block,,h,713,536870912,000000001B967540,30437120,30496760
tag_files\tag_groups.cpp,5852,64,148,bs codes,foot_tracking_block,,h,714,536870912,000000001B95DD50,30437184,30496908
tag_files\tag_groups.cpp,5852,376,460,bs codes,animation_pool_block,,h,715,536870912,000000001B912C30,30437560,30497368
tag_files\tag_groups.cpp,5852,224,308,bs codes,animation_graph_definitions_struct,,h,716,536870912,000000001B969E00,30437784,30497676
tag_files\tag_groups.cpp,5852,40,124,bs codes,animation_index_struct,,h,717,536870912,000000001B96C8C0,30437824,30497800
tag_files\tag_groups.cpp,5852,48,132,bs codes,animation_entry_block,,h,718,536870912,000000001B96D880,30437872,30497932
tag_files\tag_groups.cpp,5852,40,124,bs codes,damage_region_block,,h,719,536870912,000000001B96BF30,30437912,30498056
tag_files\tag_groups.cpp,5852,48,132,bs codes,damage_direction_block,,h,720,536870912,000000001B96C680,30437960,30498188
tag_files\tag_groups.cpp,5852,56,140,bs codes,damage_animation_block,,h,721,536870912,000000001B95D0D0,30438016,30498328
tag_files\tag_groups.cpp,5852,56,140,bs codes,animation_transition_state_struct,,h,722,536870912,000000001B95DDF0,30438072,30498468
tag_files\tag_groups.cpp,5852,64,148,bs codes,animation_destination_state_struct,,h,723,536870912,000000001B95E570,30438136,30498616
tag_files\tag_groups.cpp,5852,72,156,bs codes,animation_transition_destination_block,,h,724,536870912,000000001B969010,30438208,30498772
tag_files\tag_groups.cpp,5852,72,156,bs codes,animation_transition_block,,h,725,536870912,000000001B968460,30438280,30498928
tag_files\tag_groups.cpp,5852,128,212,bs codes,weapon_type_block,,h,726,536870912,000000001B9439C0,30438408,30499140
tag_files\tag_groups.cpp,5852,40,124,bs codes,animation_ik_block,,h,727,536870912,000000001B96C440,30438448,30499264
tag_files\tag_groups.cpp,5852,80,164,bs codes,weapon_class_block,,h,728,536870912,000000001B9689E0,30438528,30499428
tag_files\tag_groups.cpp,5852,40,124,bs codes,foot_tracking_defaults,,h,729,536870912,000000001B96D0A0,30438568,30499552
tag_files\tag_groups.cpp,5852,104,188,bs codes,animation_mode_block,,h,730,536870912,000000001B951800,30438672,30499740
tag_files\tag_groups.cpp,5852,112,196,bs codes,vehicle_suspension_block,,h,731,536870912,000000001B952DF0,30438784,30499936
tag_files\tag_groups.cpp,5852,80,164,bs codes,object_animation_block,,h,732,536870912,000000001B9675F0,30438864,30500100
tag_files\tag_groups.cpp,5852,96,180,bs codes,animation_graph_contents_struct,,h,733,536870912,000000001B959E10,30438960,30500280
tag_files\tag_groups.cpp,5852,32,116,bs codes,inherited_animation_node_map_block,,h,734,536870912,000000001B9455E0,30438992,30500396
tag_files\tag_groups.cpp,5852,32,116,bs codes,inherited_animation_node_map_flag_block,,h,735,536870912,000000001B945F60,30439024,30500512
tag_files\tag_groups.cpp,5852,120,204,bs codes,inherited_animation_block,,h,736,536870912,000000001B942920,30439144,30500716
tag_files\tag_groups.cpp,5852,40,124,bs codes,weapon_class_lookup_block,,h,737,536870912,000000001B96C710,30439184,30500840
tag_files\tag_groups.cpp,5852,152,236,bs codes,model_animation_runtime_data_struct,,h,738,536870912,000000001B94AEA0,30439336,30501076
tag_files\tag_groups.cpp,5852,144,228,bs codes,additional_node_data_block,,h,739,536870912,000000001B95FCE0,30439480,30501304
tag_files\tag_groups.cpp,5852,80,164,bs codes,packed_data_sizes_struct,,h,740,536870912,000000001B9678B0,30439560,30501468
tag_files\tag_groups.cpp,5852,120,204,bs codes,model_animation_tag_resource_member,,h,741,536870912,000000001B943480,30439680,30501672
tag_files\tag_groups.cpp,5852,48,132,bs codes,model_animation_tag_resource_struct,,h,742,536870912,000000001B96BE10,30439728,30501804
tag_files\tag_groups.cpp,5852,48,132,bs codes,model_animation_tag_resource_group,,h,743,536870912,000000001B96CC20,30439776,30501936
tag_files\tag_groups.cpp,5852,160,244,bs codes,model_animation_graph_block_struct,,h,744,536870912,000000001B94AFA0,30439936,30502180
tag_files\tag_groups.cpp,5852,360,444,bs codes,animation_pool_block__from_graph_v0,,h,745,536870912,000000001B96DF00,30440296,30502624
tag_files\tag_groups.cpp,5852,224,308,bs codes,animation_graph_definitions_struct__from_graph_v0,,h,746,536870912,000000001B96AD00,30440520,30502932
tag_files\tag_groups.cpp,5852,40,124,bs codes,animation_index_struct__from_graph_v0,,h,747,536870912,000000001B96D400,30440560,30503056
tag_files\tag_groups.cpp,5852,48,132,bs codes,animation_entry_block__from_graph_v0,,h,748,536870912,000000001B96D250,30440608,30503188
tag_files\tag_groups.cpp,5852,40,124,bs codes,damage_region_block__from_graph_v0,,h,749,536870912,000000001B96D910,30440648,30503312
tag_files\tag_groups.cpp,5852,48,132,bs codes,damage_direction_block__from_graph_v0,,h,750,536870912,000000001B96D490,30440696,30503444
tag_files\tag_groups.cpp,5852,56,140,bs codes,damage_animation_block__from_graph_v0,,h,751,536870912,000000001B96F700,30440752,30503584
tag_files\tag_groups.cpp,5852,72,156,bs codes,animation_transition_destination_block__from_graph_v0,,h,752,536870912,000000001B967B70,30440824,30503740
tag_files\tag_groups.cpp,5852,72,156,bs codes,animation_transition_block__from_graph_v0,,h,753,536870912,000000001B967E30,30440896,30503896
tag_files\tag_groups.cpp,5852,32,116,bs codes,precache_list_block,,h,754,536870912,000000001B945FE0,30440928,30504012
tag_files\tag_groups.cpp,5852,176,260,bs codes,weapon_type_block__from_graph_v0,,h,755,536870912,000000001B956C30,30441104,30504272
tag_files\tag_groups.cpp,5852,80,164,bs codes,weapon_class_block__from_graph_v0,,h,756,536870912,000000001B9681A0,30441184,30504436
tag_files\tag_groups.cpp,5852,104,188,bs codes,animation_mode_block__from_graph_v0,,h,757,536870912,000000001B953470,30441288,30504624
tag_files\tag_groups.cpp,5852,112,196,bs codes,vehicle_suspension_block__from_graph_v0,,h,758,536870912,000000001B952F90,30441400,30504820
tag_files\tag_groups.cpp,5852,80,164,bs codes,object_animation_block__from_graph_v0,,h,759,536870912,000000001B967EE0,30441480,30504984
tag_files\tag_groups.cpp,5852,96,180,bs codes,animation_graph_contents_struct__from_graph_v0,,h,760,536870912,000000001B959A50,30441576,30505164
tag_files\tag_groups.cpp,5852,136,220,bs codes,model_animation_graph_v0_struct_definition,,h,761,536870912,000000001B961540,30441712,30505384
tag_files\tag_groups.cpp,5852,80,164,bs codes,text_value_pair_reference_block,,h,762,536870912,000000001B9687D0,30441792,30505548
tag_files\tag_groups.cpp,5852,56,140,bs codes,sandbox_property_allowed_values_reference_block,,h,763,536870912,000000001B96EBC0,30441848,30505688
tag_files\tag_groups.cpp,5852,48,132,bs codes,sandbox_text_value_pair_definition_struct_definition,,h,764,536870912,000000001B96C4D0,30441896,30505820
tag_files\tag_groups.cpp,5852,32,116,bs codes,damage_outer_cone_angle_struct,,h,765,536870912,000000001B946260,30441928,30505936
tag_files\tag_groups.cpp,5852,24,108,bs codes,damage_outer_cone_angle_fields_v1,,h,766,536870912,000000001B9462E0,30441952,30506044
tag_files\tag_groups.cpp,5852,104,188,bs codes,screen_flash_definition_struct,,h,767,536870912,000000001B952430,30442056,30506232
tag_files\tag_groups.cpp,5852,48,132,bs codes,rumble_frequency_definition_struct,,h,768,536870912,000000001B96D520,30442104,30506364
tag_files\tag_groups.cpp,5852,56,140,bs codes,rumble_definition_struct,,h,769,536870912,000000001B96EF80,30442160,30506504
tag_files\tag_groups.cpp,5852,56,140,bs codes,damage_effect_sound_effect_definition,,h,770,536870912,000000001B96E9E0,30442216,30506644
tag_files\tag_groups.cpp,5852,88,172,bs codes,damage_effect_player_response_block,,h,771,536870912,000000001B959F90,30442304,30506816
tag_files\tag_groups.cpp,5852,544,628,bs codes,damage_effect_group,,h,772,536870912,000000001B9700E0,30442848,30507444
tag_files\tag_groups.cpp,5852,600,684,bs codes,damage_effect_fields_v1,,h,773,536870912,000000001B970360,30443448,30508128
tag_files\tag_groups.cpp,5852,40,124,bs codes,scalar_function_named_struct,,h,774,536870912,000000001B96BB40,30443488,30508252
tag_files\tag_groups.cpp,5852,256,340,bs codes,lens_flare_reflection_block,,h,775,536870912,000000001B95F0E0,30443744,30508592
tag_files\tag_groups.cpp,5852,40,124,bs codes,lens_flare_scalar_animation_block,,h,776,536870912,000000001B96C7A0,30443784,30508716
tag_files\tag_groups.cpp,5852,80,164,bs codes,lens_flare_color_function_struct,,h,777,536870912,000000001B968250,30443864,30508880
tag_files\tag_groups.cpp,5852,40,124,bs codes,lens_flare_color_animation_block,,h,778,536870912,000000001B96BFC0,30443904,30509004
tag_files\tag_groups.cpp,5852,376,460,bs codes,lens_flare_struct_definition,,h,779,536870912,000000001B9120F0,30444280,30509464
tag_files\tag_groups.cpp,5852,80,164,bs codes,light_color_function_struct,,h,780,536870912,000000001B967CD0,30444360,30509628
tag_files\tag_groups.cpp,5852,80,164,bs codes,light_scalar_function_struct,,h,781,536870912,000000001B968510,30444440,30509792
tag_files\tag_groups.cpp,5852,240,324,bs codes,light_struct_definition,,h,782,536870912,000000001B962A80,30444680,30510116
tag_files\tag_groups.cpp,5852,320,404,bs codes,looping_sound_track_block,,h,783,536870912,000000001B970620,30445000,30510520
tag_files\tag_groups.cpp,5852,232,316,bs codes,looping_sound_track_fields_v1,,h,784,536870912,000000001B9623F0,30445232,30510836
tag_files\tag_groups.cpp,5852,144,228,bs codes,looping_sound_detail_block,,h,785,536870912,000000001B960640,30445376,30511064
tag_files\tag_groups.cpp,5852,144,228,bs codes,looping_sound_detail_fields_v1,,h,786,536870912,000000001B95FEC0,30445520,30511292
tag_files\tag_groups.cpp,5852,160,244,bs codes,sound_looping_group,,h,787,536870912,000000001B94B3A0,30445680,30511536
tag_files\tag_groups.cpp,5852,160,244,bs codes,looping_sound_fields_v2,,h,788,536870912,000000001B94BBA0,30445840,30511780
tag_files\tag_groups.cpp,5852,152,236,bs codes,looping_sound_fields_v1,,h,789,536870912,000000001B94C9A0,30445992,30512016
tag_files\tag_groups.cpp,5852,288,372,bs codes,gui_list_widget_definition_struct_definition,,h,790,536870912,000000001B9707C0,30446280,30512388
tag_files\tag_groups.cpp,5852,152,236,bs codes,leaf_type_block,,h,791,536870912,000000001B94B5A0,30446432,30512624
tag_files\tag_groups.cpp,5852,200,284,bs codes,leaf_system_struct_definition,,h,792,536870912,000000001B971EF0,30446632,30512908
tag_files\tag_groups.cpp,5852,168,252,bs codes,shader_light_volume_struct_definition,,h,793,536870912,000000001B955F70,30446800,30513160
tag_files\tag_groups.cpp,5852,96,180,bs codes,light_volume_property_real,,h,794,536870912,000000001B959150,30446896,30513340
tag_files\tag_groups.cpp,5852,96,180,bs codes,light_volume_property_real_rgb_color,,h,795,536870912,000000001B959450,30446992,30513520
tag_files\tag_groups.cpp,5852,240,324,bs codes,light_volume_definition_block,,h,796,536870912,000000001B961D60,30447232,30513844
tag_files\tag_groups.cpp,5852,48,132,bs codes,light_volume_system_struct_definition,,h,797,536870912,000000001B96D370,30447280,30513976
tag_files\tag_groups.cpp,5852,96,180,bs codes,device_machine_struct_definition,,h,798,536870912,000000001B9595D0,30447376,30514156
tag_files\tag_groups.cpp,5852,920,1004,bs codes,device_machine_struct_definition,,h,799,536870912,000000001B972950,30448296,30515160
tag_files\tag_groups.cpp,5852,32,116,bs codes,data_hash_definition,,h,800,536870912,000000001B946360,30448328,30515276
tag_files\tag_groups.cpp,5852,168,252,bs codes,language_pack_definition,,h,801,536870912,000000001B956900,30448496,30515528
tag_files\tag_groups.cpp,5852,56,140,bs codes,havok_cleanup_resources_block,,h,802,536870912,000000001B96EC60,30448552,30515668
tag_files\tag_groups.cpp,5852,184,268,bs codes,sound_globals_block,,h,803,536870912,000000001B93D0C0,30448736,30515936
tag_files\tag_groups.cpp,5852,48,132,bs codes,ai_globals_gravemind_block,,h,804,536870912,000000001B96C3B0,30448784,30516068
tag_files\tag_groups.cpp,5852,56,140,bs codes,ai_globals_styles_block,,h,805,536870912,000000001B96E300,30448840,30516208
tag_files\tag_groups.cpp,5852,480,564,bs codes,ai_globals_block,,h,806,536870912,000000001B972D50,30449320,30516772
tag_files\tag_groups.cpp,5852,40,124,bs codes,armor_modifier_block,,h,807,536870912,000000001B96CD40,30449360,30516896
tag_files\tag_groups.cpp,5852,56,140,bs codes,damage_group_block,,h,808,536870912,000000001B96FFC0,30449416,30517036
tag_files\tag_groups.cpp,5852,48,132,bs codes,game_globals_damage_block,,h,809,536870912,000000001B96D7F0,30449464,30517168
tag_files\tag_groups.cpp,5852,360,444,bs codes,camera_block,,h,810,536870912,000000001B972F90,30449824,30517612
tag_files\tag_groups.cpp,5852,32,116,bs codes,look_function_block,,h,811,536870912,000000001B9451E0,30449856,30517728
tag_files\tag_groups.cpp,5852,248,332,bs codes,player_control_block,,h,812,536870912,000000001B95EB60,30450104,30518060
tag_files\tag_groups.cpp,5852,952,1036,bs codes,difficulty_block,,h,813,536870912,000000001B975170,30451056,30519096
tag_files\tag_groups.cpp,5852,136,220,bs codes,grenades_block,,h,814,536870912,000000001B960820,30451192,30519316
tag_files\tag_groups.cpp,5852,184,268,bs codes,interface_tag_references,,h,815,536870912,000000001B93DD20,30451376,30519584
tag_files\tag_groups.cpp,5852,408,492,bs codes,player_information_block,,h,816,536870912,0000000000FDC870,30451784,30520076
tag_files\tag_groups.cpp,5852,224,308,bs codes,player_representation_block,,h,817,536870912,000000001B96AA80,30452008,30520384
tag_files\tag_groups.cpp,5852,264,348,bs codes,falling_damage_block,,h,818,536870912,000000001B92D5B0,30452272,30520732
tag_files\tag_groups.cpp,5852,104,188,bs codes,material_physics_drag_properties_block,,h,819,536870912,000000001B953200,30452376,30520920
tag_files\tag_groups.cpp,5852,80,164,bs codes,material_physics_properties_struct,,h,820,536870912,000000001B967D80,30452456,30521084
tag_files\tag_groups.cpp,5852,24,108,bs codes,material_physics_properties_fields_v1,,h,821,536870912,000000001B945060,30452480,30521192
tag_files\tag_groups.cpp,5852,576,660,bs codes,materials_sweeteners_struct,,h,822,536870912,000000001B975590,30453056,30521852
tag_files\tag_groups.cpp,5852,56,140,bs codes,underwater_proxies_block,,h,823,536870912,000000001B96E580,30453112,30521992
tag_files\tag_groups.cpp,5852,192,276,bs codes,materials_block,,h,824,536870912,000000001B93D9C0,30453304,30522268
tag_files\tag_groups.cpp,5852,48,132,bs codes,multiplayer_color_block,,h,825,536870912,000000001B96C200,30453352,30522400
tag_files\tag_groups.cpp,5852,64,148,bs codes,cinematics_globals_block,,h,826,536870912,000000001B96F5C0,30453416,30522548
tag_files\tag_groups.cpp,5852,32,116,bs codes,campaign_metagame_style_type_block,,h,827,536870912,000000001B945DE0,30453448,30522664
tag_files\tag_groups.cpp,5852,32,116,bs codes,campaign_metagame_difficulty_scale_block,,h,828,536870912,000000001B945260,30453480,30522780
tag_files\tag_groups.cpp,5852,32,116,bs codes,campaign_metagame_primary_skull_block,,h,829,536870912,000000001B945660,30453512,30522896
tag_files\tag_groups.cpp,5852,32,116,bs codes,campaign_metagame_secondary_skull_block,,h,830,536870912,000000001B946560,30453544,30523012
tag_files\tag_groups.cpp,5852,168,252,bs codes,campaign_metagame_globals_block,,h,831,536870912,000000001B9573A0,30453712,30523264
tag_files\tag_groups.cpp,5852,960,1044,bs codes,globals_struct_definition,,h,832,536870912,000000001B975830,30454672,30524308
tag_files\tag_groups.cpp,5852,56,140,bs codes,mouse_cursor_bitmap_reference_block,,h,833,536870912,000000001B96F660,30454728,30524448
tag_files\tag_groups.cpp,5852,56,140,bs codes,mouse_cursor_definition_struct_definition,,h,834,536870912,000000001B96FA20,30454784,30524588
tag_files\tag_groups.cpp,5852,176,260,bs codes,gui_model_widget_definition_struct_definition,,h,835,536870912,000000001B956E50,30454960,30524848
tag_files\tag_groups.cpp,5852,72,156,bs codes,mission_dialogue_variants_block,,h,836,536870912,000000001B9690C0,30455032,30525004
tag_files\tag_groups.cpp,5852,64,148,bs codes,mission_dialogue_lines_block,,h,837,536870912,000000001B96F480,30455096,30525152
tag_files\tag_groups.cpp,5852,48,132,bs codes,ai_mission_dialogue_struct_definition,,h,838,536870912,000000001B96CF80,30455144,30525284
tag_files\tag_groups.cpp,5852,288,372,bs codes,meter_struct_definition,,h,839,536870912,000000001B975C50,30455432,30525656
tag_files\tag_groups.cpp,5852,32,116,bs codes,muffin_permutation_name_block,,h,840,536870912,000000001B9456E0,30455464,30525772
tag_files\tag_groups.cpp,5852,48,132,bs codes,muffin_marker_block,,h,841,536870912,000000001B96D130,30455512,30525904
tag_files\tag_groups.cpp,5852,40,124,bs codes,muffin_scalar_function_struct,,h,842,536870912,000000001B96BD80,30455552,30526028
tag_files\tag_groups.cpp,5852,208,292,bs codes,global_muffin_type_struct,,h,843,536870912,000000001B972740,30455760,30526320
tag_files\tag_groups.cpp,5852,136,220,bs codes,muffin_block,,h,844,536870912,000000001B960AF0,30455896,30526540
tag_files\tag_groups.cpp,5852,80,164,bs codes,render_model_permutation_block,,h,845,536870912,000000001B9685C0,30455976,30526704
tag_files\tag_groups.cpp,5852,56,140,bs codes,render_model_region_block,,h,846,536870912,000000001B96FC00,30456032,30526844
tag_files\tag_groups.cpp,5852,144,228,bs codes,global_render_model_instance_placement_block,,h,847,536870912,000000001B95FDD0,30456176,30527072
tag_files\tag_groups.cpp,5852,232,316,bs codes,render_model_node_block,,h,848,536870912,000000001B962690,30456408,30527388
tag_files\tag_groups.cpp,5852,120,204,bs codes,render_model_marker_block,,h,849,536870912,000000001B942AE0,30456528,30527592
tag_files\tag_groups.cpp,5852,56,140,bs codes,render_model_marker_group_block,,h,850,536870912,000000001B96F8E0,30456584,30527732
tag_files\tag_groups.cpp,5852,56,140,bs codes,global_geometry_material_property_block,,h,851,536870912,000000001B96E800,30456640,30527872
tag_files\tag_groups.cpp,5852,104,188,bs codes,global_geometry_material_block,,h,852,536870912,000000001B9519A0,30456744,30528060
tag_files\tag_groups.cpp,5852,80,164,bs codes,sky_lights_block,,h,853,536870912,000000001B968B40,30456824,30528224
tag_files\tag_groups.cpp,5852,32,116,bs codes,default_lightprobe,,h,854,536870912,000000001B945C60,30456856,30528340
tag_files\tag_groups.cpp,5852,32,116,bs codes,radiance_transfer_matrix,,h,855,536870912,000000001B945CE0,30456888,30528456
tag_files\tag_groups.cpp,5852,88,172,bs codes,volume_samples_block,,h,856,536870912,000000001B95A1D0,30456976,30528628
tag_files\tag_groups.cpp,5852,88,172,bs codes,default_node_orientations_block,,h,857,536870912,000000001B958C10,30457064,30528800
tag_files\tag_groups.cpp,5852,456,540,bs codes,render_model_block_struct,,h,858,536870912,000000001B975DD0,30457520,30529340
tag_files\tag_groups.cpp,5852,104,188,bs codes,scenario_description_block,,h,859,536870912,000000001B951DB0,30457624,30529528
tag_files\tag_groups.cpp,5852,48,132,bs codes,multiplayer_scenario_description_struct_definition,,h,860,536870912,000000001B96D9A0,30457672,30529660
tag_files\tag_groups.cpp,5852,48,132,bs codes,multiplayer_color_block,,h,861,536870912,000000001B96CA70,30457720,30529792
tag_files\tag_groups.cpp,5852,40,124,bs codes,customized_model_bits_block,,h,862,536870912,000000001B96D010,30457760,30529916
tag_files\tag_groups.cpp,5852,64,148,bs codes,customized_model_selection_block,,h,863,536870912,000000001B96EE40,30457824,30530064
tag_files\tag_groups.cpp,5852,56,140,bs codes,customized_model_area_block,,h,864,536870912,000000001B96F7A0,30457880,30530204
tag_files\tag_groups.cpp,5852,56,140,bs codes,customized_model_characters_block,,h,865,536870912,000000001B96FAC0,30457936,30530344
tag_files\tag_groups.cpp,5852,72,156,bs codes,weapon_selections_block,,h,866,536870912,000000001B968D50,30458008,30530500
tag_files\tag_groups.cpp,5852,64,148,bs codes,vehicle_selections_block,,h,867,536870912,000000001B96FB60,30458072,30530648
tag_files\tag_groups.cpp,5852,64,148,bs codes,grenade_selections_block,,h,868,536870912,000000001B96F520,30458136,30530796
tag_files\tag_groups.cpp,5852,72,156,bs codes,equipment_selection_block,,h,869,536870912,000000001B968A90,30458208,30530952
tag_files\tag_groups.cpp,5852,40,124,bs codes,object_remap_entry_block,,h,870,536870912,000000001B96CDD0,30458248,30531076
tag_files\tag_groups.cpp,5852,56,140,bs codes,multiplayer_weapon_set_block,,h,871,536870912,000000001B96E1C0,30458304,30531216
tag_files\tag_groups.cpp,5852,56,140,bs codes,multiplayer_vehicle_set_block,,h,872,536870912,000000001B96E440,30458360,30531356
tag_files\tag_groups.cpp,5852,440,524,bs codes,multiplayer_universal_block,,h,873,536870912,000000000108A0F0,30458800,30531880
tag_files\tag_groups.cpp,5852,56,140,bs codes,sounds_block,,h,874,536870912,000000001B96E3A0,30458856,30532020
tag_files\tag_groups.cpp,5852,56,140,bs codes,looping_sounds_block,,h,875,536870912,000000001B96F160,30458912,30532160
tag_files\tag_groups.cpp,5852,376,460,bs codes,sound_response_extra_sounds_struct,,h,876,536870912,000000001B9122D0,30459288,30532620
tag_files\tag_groups.cpp,5852,24,108,bs codes,sound_response_extra_sounds_fields_v1,,h,877,536870912,000000001B945E60,30459312,30532728
tag_files\tag_groups.cpp,5852,96,180,bs codes,sound_response_definition_block,,h,878,536870912,000000001B958490,30459408,30532908
tag_files\tag_groups.cpp,5852,264,348,bs codes,game_engine_general_event_block,,h,879,536870912,000000001B92CBA0,30459672,30533256
tag_files\tag_groups.cpp,5852,264,348,bs codes,game_engine_flavor_event_block,,h,880,536870912,000000001B92DCE0,30459936,30533604
tag_files\tag_groups.cpp,5852,264,348,bs codes,game_engine_slayer_event_block,,h,881,536870912,000000001B92D720,30460200,30533952
tag_files\tag_groups.cpp,5852,264,348,bs codes,game_engine_ctf_event_block,,h,882,536870912,000000001B92C470,30460464,30534300
tag_files\tag_groups.cpp,5852,264,348,bs codes,game_engine_oddball_event_block,,h,883,536870912,000000001B92CE80,30460728,30534648
tag_files\tag_groups.cpp,5852,264,348,bs codes,game_engine_king_event_block,,h,884,536870912,000000001B92D890,30460992,30534996
tag_files\tag_groups.cpp,5852,264,348,bs codes,game_engine_vip_event_block,,h,885,536870912,000000001B92DE50,30461256,30535344
tag_files\tag_groups.cpp,5852,264,348,bs codes,game_engine_juggernaut_event_block,,h,886,536870912,000000001B92E130,30461520,30535692
tag_files\tag_groups.cpp,5852,264,348,bs codes,game_engine_territories_event_block,,h,887,536870912,000000001B92DFC0,30461784,30536040
tag_files\tag_groups.cpp,5852,264,348,bs codes,game_engine_assault_event_block,,h,888,536870912,000000001B92C8C0,30462048,30536388
tag_files\tag_groups.cpp,5852,264,348,bs codes,game_engine_infection_event_block,,h,889,536870912,000000001B92C750,30462312,30536736
tag_files\tag_groups.cpp,5852,264,348,bs codes,game_engine_gun_game_event_block,,h,890,536870912,000000001B92DB70,30462576,30537084
tag_files\tag_groups.cpp,5852,88,172,bs codes,weapon_spawn_influence_block,,h,891,536870912,000000001B958550,30462664,30537256
tag_files\tag_groups.cpp,5852,88,172,bs codes,vehicle_spawn_influence_block,,h,892,536870912,000000001B959210,30462752,30537428
tag_files\tag_groups.cpp,5852,80,164,bs codes,projectile_spawn_influence_block,,h,893,536870912,000000001B967C20,30462832,30537592
tag_files\tag_groups.cpp,5852,64,148,bs codes,equipment_spawn_influence_block,,h,894,536870912,000000001B96E4E0,30462896,30537740
tag_files\tag_groups.cpp,5852,64,148,bs codes,auto_turret_spawn_influencers_block,,h,895,536870912,000000001B96ED00,30462960,30537888
tag_files\tag_groups.cpp,5852,1008,1092,bs codes,multiplayer_constants_block,,h,896,536870912,000000001B976000,30463968,30538980
tag_files\tag_groups.cpp,5852,56,140,bs codes,game_engine_status_response_block,,h,897,536870912,000000001B96FCA0,30464024,30539120
tag_files\tag_groups.cpp,5852,1128,1212,bs codes,multiplayer_runtime_block,,h,898,536870912,000000001B976450,30465152,30540332
tag_files\tag_groups.cpp,5852,72,156,bs codes,multiplayer_globals_struct_definition,,h,899,536870912,000000001B969170,30465224,30540488
tag_files\tag_groups.cpp,5852,88,172,bs codes,cinematic_sh_light_block,,h,900,536870912,000000001B959690,30465312,30540660
tag_files\tag_groups.cpp,5852,88,172,bs codes,cinematic_dynamic_light_block,,h,901,536870912,000000001B959750,30465400,30540832
tag_files\tag_groups.cpp,5852,80,164,bs codes,new_cinematic_lighting_struct_definition,,h,902,536870912,000000001B9676A0,30465480,30540996
tag_files\tag_groups.cpp,5852,144,228,bs codes,performane_throttle_block,,h,903,536870912,000000001B961270,30465624,30541224
tag_files\tag_groups.cpp,5852,48,132,bs codes,performance_throttles_struct_definition,,h,904,536870912,000000001B96D760,30465672,30541356
tag_files\tag_groups.cpp,5852,72,156,bs codes,physics_model_damped_spring_motor_block,,h,905,536870912,000000001B968670,30465744,30541512
tag_files\tag_groups.cpp,5852,88,172,bs codes,physics_model_position_motor_block,,h,906,536870912,000000001B959810,30465832,30541684
tag_files\tag_groups.cpp,5852,184,268,bs codes,phantom_types_block,,h,907,536870912,000000001B93D1E0,30466016,30541952
tag_files\tag_groups.cpp,5852,168,252,bs codes,phantom_type_fields_v0,,h,908,536870912,000000001B9564C0,30466184,30542204
tag_files\tag_groups.cpp,5852,32,116,bs codes,physics_model_powered_chain_nodes_block,,h,909,536870912,000000001B945760,30466216,30542320
tag_files\tag_groups.cpp,5852,40,124,bs codes,physics_model_motor_reference_struct,,h,910,536870912,000000001B96D1C0,30466256,30542444
tag_files\tag_groups.cpp,5852,88,172,bs codes,physics_model_powered_chain_constraints_block,,h,911,536870912,000000001B9598D0,30466344,30542616
tag_files\tag_groups.cpp,5852,72,156,bs codes,physics_model_powered_chains_block,,h,912,536870912,000000001B969220,30466416,30542772
tag_files\tag_groups.cpp,5852,72,156,bs codes,physics_model_ragdoll_motors_block,,h,913,536870912,000000001B967960,30466488,30542928
tag_files\tag_groups.cpp,5852,40,124,bs codes,physics_model_limited_hinge_motors_block,,h,914,536870912,000000001B96C830,30466528,30543052
tag_files\tag_groups.cpp,5852,104,188,bs codes,physics_model_constraint_edge_constraint_block,,h,915,536870912,000000001B953060,30466632,30543240
tag_files\tag_groups.cpp,5852,96,180,bs codes,physics_model_node_constraint_edge_block,,h,916,536870912,000000001B9779F0,30466728,30543420
tag_files\tag_groups.cpp,5852,424,508,bs codes,rigid_bodies_block,,h,917,536870912,000000001B90B530,30467152,30543928
tag_files\tag_groups.cpp,5852,288,372,bs codes,rigid_bodies_block_fields_v1,,h,918,536870912,000000001B978930,30467440,30544300
tag_files\tag_groups.cpp,5852,64,148,bs codes,materials_block,,h,919,536870912,000000001B96F200,30467504,30544448
tag_files\tag_groups.cpp,5852,56,140,bs codes,multi_sphere_vector_storage,,h,920,536870912,000000001B96F840,30467560,30544588
tag_files\tag_groups.cpp,5852,112,196,bs codes,multi_spheres_block,,h,921,536870912,000000001B952AB0,30467672,30544784
tag_files\tag_groups.cpp,5852,208,292,bs codes,havok_convex_transform_shape_struct,,h,922,536870912,000000001B972280,30467880,30545076
tag_files\tag_groups.cpp,5852,112,196,bs codes,boxes_block_struct,,h,923,536870912,000000001B951F50,30467992,30545272
tag_files\tag_groups.cpp,5852,112,196,bs codes,old_boxes_block,,h,924,536870912,000000001B9529E0,30468104,30545468
tag_files\tag_groups.cpp,5852,216,300,bs codes,triangles_block,,h,925,536870912,000000001B96AF80,30468320,30545768
tag_files\tag_groups.cpp,5852,200,284,bs codes,polyhedra_block,,h,926,536870912,000000001B9723B0,30468520,30546052
tag_files\tag_groups.cpp,5852,120,204,bs codes,polyhedron_four_vectors_block,,h,927,536870912,000000001B942BC0,30468640,30546256
tag_files\tag_groups.cpp,5852,56,140,bs codes,polyhedron_plane_equations_block,,h,928,536870912,000000001B96EDA0,30468696,30546396
tag_files\tag_groups.cpp,5852,152,236,bs codes,mass_distributions_block,,h,929,536870912,000000001B94BDA0,30468848,30546632
tag_files\tag_groups.cpp,5852,128,212,bs codes,lists_block,,h,930,536870912,000000001B942D80,30468976,30546844
tag_files\tag_groups.cpp,5852,72,156,bs codes,list_shapes_block,,h,931,536870912,000000001B968BF0,30469048,30547000
tag_files\tag_groups.cpp,5852,96,180,bs codes,mopps_block,,h,932,536870912,000000001B977330,30469144,30547180
tag_files\tag_groups.cpp,5852,272,356,bs codes,constraint_bodies_struct,,h,933,536870912,000000001B92CD10,30469416,30547536
tag_files\tag_groups.cpp,5852,48,132,bs codes,hinge_constraints_block,,h,934,536870912,000000001B96C9E0,30469464,30547668
tag_files\tag_groups.cpp,5852,104,188,bs codes,ragdoll_constraints_block,,h,935,536870912,000000001B952B80,30469568,30547856
tag_files\tag_groups.cpp,5852,32,116,bs codes,rigid_body_indices_block,,h,936,536870912,000000001B9457E0,30469600,30547972
tag_files\tag_groups.cpp,5852,56,140,bs codes,permutations_block,,h,937,536870912,000000001B96EEE0,30469656,30548112
tag_files\tag_groups.cpp,5852,56,140,bs codes,regions_block,,h,938,536870912,000000001B96E120,30469712,30548252
tag_files\tag_groups.cpp,5852,64,148,bs codes,nodes_block,,h,939,536870912,000000001B96EA80,30469776,30548400
tag_files\tag_groups.cpp,5852,56,140,bs codes,point_to_path_curve_point_block,,h,940,536870912,000000001B96F020,30469832,30548540
tag_files\tag_groups.cpp,5852,72,156,bs codes,point_to_path_curve_block,,h,941,536870912,000000001B968720,30469904,30548696
tag_files\tag_groups.cpp,5852,72,156,bs codes,limited_hinge_constraints_block,,h,942,536870912,000000001B9680F0,30469976,30548852
tag_files\tag_groups.cpp,5852,48,132,bs codes,ball_and_socket_constraints_block,,h,943,536870912,000000001B96DA30,30470024,30548984
tag_files\tag_groups.cpp,5852,56,140,bs codes,stiff_spring_constraints_block,,h,944,536870912,000000001B96E8A0,30470080,30549124
tag_files\tag_groups.cpp,5852,72,156,bs codes,prismatic_constraints_block,,h,945,536870912,000000001B968880,30470152,30549280
tag_files\tag_groups.cpp,5852,88,172,bs codes,phantoms_block,,h,946,536870912,000000001B978830,30470240,30549452
tag_files\tag_groups.cpp,5852,848,932,bs codes,physics_model_struct_definition,,h,947,536870912,000000001B978AB0,30471088,30550384
tag_files\tag_groups.cpp,5852,56,140,bs codes,havok2_shape_struct,,h,948,536870912,000000001B96F0C0,30471144,30550524
tag_files\tag_groups.cpp,5852,48,132,bs codes,havok2_convex_shape_struct,,h,949,536870912,000000001B96C950,30471192,30550656
tag_files\tag_groups.cpp,5852,120,204,bs codes,havok2_rotated_vertices_storage,,h,950,536870912,000000001B943640,30471312,30550860
tag_files\tag_groups.cpp,5852,240,324,bs codes,havok2_polyhedra_block,,h,951,536870912,000000001B961EB0,30471552,30551184
tag_files\tag_groups.cpp,5852,56,140,bs codes,havok2_list_child_shape_storage,,h,952,536870912,000000001B96EB20,30471608,30551324
tag_files\tag_groups.cpp,5852,104,188,bs codes,havok2_lists_block,,h,953,536870912,000000001B952020,30471712,30551512
tag_files\tag_groups.cpp,5852,848,932,bs codes,physics_model_tags_v2,,h,954,536870912,000000001B978E60,30472560,30552444
tag_files\tag_groups.cpp,5852,848,932,bs codes,physics_model_tags_v2,,h,955,536870912,000000001B979210,30473408,30553376
tag_files\tag_groups.cpp,5852,24,108,bs codes,g_null_block,,h,956,536870912,000000001B945860,30473432,30553484
tag_files\tag_groups.cpp,5852,544,628,bs codes,physics_model_tags_v1,,h,957,536870912,000000001B9795C0,30473976,30554112
tag_files\tag_groups.cpp,5852,40,124,bs codes,pixel_entry_point_block,,h,958,536870912,000000001B96D2E0,30474016,30554236
tag_files\tag_groups.cpp,5852,88,172,bs codes,pixel_shader_block_struct,,h,959,536870912,000000001B976F70,30474104,30554408
tag_files\tag_groups.cpp,5852,56,140,bs codes,cache_file_codec_identifier_block,,h,960,536870912,000000001B96F2A0,30474160,30554548
tag_files\tag_groups.cpp,5852,56,140,bs codes,cache_file_shared_file_block,,h,961,536870912,000000001B96F340,30474216,30554688
tag_files\tag_groups.cpp,5852,32,116,bs codes,resource_hash_definition,,h,962,536870912,000000001B945960,30474248,30554804
tag_files\tag_groups.cpp,5852,152,236,bs codes,resource_checksum_struct,,h,963,536870912,000000001B94CBA0,30474400,30555040
tag_files\tag_groups.cpp,5852,120,204,bs codes,cache_file_resource_location_struct,,h,964,536870912,000000001B942E60,30474520,30555244
tag_files\tag_groups.cpp,5852,40,124,bs codes,cache_file_resource_streaming_sublocation_block,,h,965,536870912,000000001B96CE60,30474560,30555368
tag_files\tag_groups.cpp,5852,56,140,bs codes,cache_file_resource_streaming_sublocation_table_block,,h,966,536870912,000000001B96F980,30474616,30555508
tag_files\tag_groups.cpp,5852,48,132,bs codes,cache_file_resource_patch_lookup_block,,h,967,536870912,000000001B96CB00,30474664,30555640
tag_files\tag_groups.cpp,5852,72,156,bs codes,cache_file_resource_default_location_block,,h,968,536870912,000000001B968300,30474736,30555796
tag_files\tag_groups.cpp,5852,184,268,bs codes,cache_file_resource_layout_table_block_struct,,h,969,536870912,000000001B93D300,30474920,30556064
tag_files\tag_groups.cpp,5852,32,116,bs codes,gpu_single_constant_register_array,,h,970,536870912,000000001B9465E0,30474952,30556180
tag_files\tag_groups.cpp,5852,64,148,bs codes,gpu_variants_block,,h,971,536870912,000000001B96FD40,30475016,30556328
tag_files\tag_groups.cpp,5852,48,132,bs codes,gpu_data_struct,,h,972,536870912,000000001B96BBD0,30475064,30556460
tag_files\tag_groups.cpp,5852,56,140,bs codes,particle_model_struct_definition,,h,973,536870912,000000001B96F3E0,30475120,30556600
tag_files\tag_groups.cpp,5852,88,172,bs codes,particle_physics_struct_definition,,h,974,536870912,000000001B976C70,30475208,30556772
tag_files\tag_groups.cpp,5852,136,220,bs codes,point_physics_struct_definition,,h,975,536870912,000000001B961630,30475344,30556992
tag_files\tag_groups.cpp,5852,56,140,bs codes,super_detonation_damage_struct,,h,976,536870912,000000001B96FDE0,30475400,30557132
tag_files\tag_groups.cpp,5852,24,108,bs codes,super_detonation_damage_fields_v1,,h,977,536870912,000000001B9463E0,30475424,30557240
tag_files\tag_groups.cpp,5852,32,116,bs codes,angular_velocity_lower_bound_struct,,h,978,536870912,000000001B946460,30475456,30557356
tag_files\tag_groups.cpp,5852,24,108,bs codes,angular_velocity_lower_bound_fields_v1,,h,979,536870912,000000001B9464E0,30475480,30557464
tag_files\tag_groups.cpp,5852,184,268,bs codes,projectile_material_response_block,,h,980,536870912,000000001B93C220,30475664,30557732
tag_files\tag_groups.cpp,5852,120,204,bs codes,brute_grenade_block,,h,981,536870912,000000001B943AA0,30475784,30557936
tag_files\tag_groups.cpp,5852,32,116,bs codes,fire_bomb_grenade_block,,h,982,536870912,000000001B946660,30475816,30558052
tag_files\tag_groups.cpp,5852,56,140,bs codes,conical_projection_block,,h,983,536870912,000000001B96FE80,30475872,30558192
tag_files\tag_groups.cpp,5852,904,988,bs codes,projectile_group,,h,984,536870912,000000001B97B850,30476776,30559180
tag_files\tag_groups.cpp,5852,1416,1500,bs codes,projectile_group,,h,985,536870912,000000001B97BC40,30478192,30560680
tag_files\tag_groups.cpp,5852,1048,1132,bs codes,projectile_fields_v1,,h,986,536870912,000000001B97C230,30479240,30561812
tag_files\tag_groups.cpp,5852,88,172,bs codes,attachment_block,,h,987,536870912,000000001B9782F0,30479328,30561984
tag_files\tag_groups.cpp,5852,64,148,bs codes,gpu_sprite_block,,h,988,536870912,000000001B96FF20,30479392,30562132
tag_files\tag_groups.cpp,5852,72,156,bs codes,gpu_data_struct,,h,989,536870912,000000001B968CA0,30479464,30562288
tag_files\tag_groups.cpp,5852,368,452,bs codes,particle_struct_definition,,h,990,536870912,000000001B97C6B0,30479832,30562740
tag_files\tag_groups.cpp,5852,64,148,bs codes,default_textures_refs_block,,h,991,536870912,000000001B96E260,30479896,30562888
tag_files\tag_groups.cpp,5852,56,140,bs codes,material_textures_refs_block,,h,992,536870912,000000001B96E620,30479952,30563028
tag_files\tag_groups.cpp,5852,120,204,bs codes,explicit_shader_refs_block,,h,993,536870912,000000001B943720,30480072,30563232
tag_files\tag_groups.cpp,5852,352,436,bs codes,rasterizer_globals_struct_definition,,h,994,536870912,000000001B97C880,30480424,30563668
tag_files\tag_groups.cpp,5852,40,124,bs codes,shader_beam_struct_definition,,h,995,536870912,000000001B96D5B0,30480464,30563792
tag_files\tag_groups.cpp,5852,48,132,bs codes,shader_custom_struct_definition,,h,996,536870912,000000001B96C050,30480512,30563924
tag_files\tag_groups.cpp,5852,176,260,bs codes,shader_custom_struct_definition,,h,997,536870912,000000001B955800,30480688,30564184
tag_files\tag_groups.cpp,5852,48,132,bs codes,shader_cortana_struct_definition,,h,998,536870912,000000001B96C290,30480736,30564316
tag_files\tag_groups.cpp,5852,176,260,bs codes,shader_cortana_struct_definition,,h,999,536870912,000000001B956080,30480912,30564576
tag_files\tag_groups.cpp,5852,40,124,bs codes,shader_decal_struct_definition,,h,1000,536870912,000000001B96C0E0,30480952,30564700
tag_files\tag_groups.cpp,5852,80,164,bs codes,render_method_options_block,,h,1001,536870912,000000001B968EB0,30481032,30564864
tag_files\tag_groups.cpp,5852,72,156,bs codes,render_method_category_block,,h,1002,536870912,000000001B967A10,30481104,30565020
tag_files\tag_groups.cpp,5852,32,116,bs codes,render_method_pass_category_dependencies,,h,1003,536870912,000000001B97CE10,30481136,30565136
tag_files\tag_groups.cpp,5852,64,148,bs codes,render_method_pass_block,,h,1004,536870912,000000001B96E6C0,30481200,30565284
tag_files\tag_groups.cpp,5852,56,140,bs codes,render_method_entry_points_block,,h,1005,536870912,000000001B96E760,30481256,30565424
tag_files\tag_groups.cpp,5852,56,140,bs codes,entry_point_dependencies_block,,h,1006,536870912,000000001B96E940,30481312,30565564
tag_files\tag_groups.cpp,5852,64,148,bs codes,vertex_types_block,,h,1007,536870912,000000001B980080,30481376,30565712
tag_files\tag_groups.cpp,5852,208,292,bs codes,render_method_definition_struct_definition,,h,1008,536870912,000000001B9710B0,30481584,30566004
tag_files\tag_groups.cpp,5852,48,132,bs codes,shader_foliage_struct_definition,,h,1009,536870912,000000001B96BEA0,30481632,30566136
tag_files\tag_groups.cpp,5852,176,260,bs codes,shader_foliage_struct_definition,,h,1010,536870912,000000001B956D40,30481808,30566396
tag_files\tag_groups.cpp,5852,48,132,bs codes,shader_halogram_struct_definition,,h,1011,536870912,000000001B96CEF0,30481856,30566528
tag_files\tag_groups.cpp,5852,176,260,bs codes,shader_halogram_struct_definition,,h,1012,536870912,000000001B955910,30482032,30566788
tag_files\tag_groups.cpp,5852,40,124,bs codes,shader_light_volume_struct_definition,,h,1013,536870912,000000001B96BC60,30482072,30566912
tag_files\tag_groups.cpp,5852,200,284,bs codes,render_method_option_parameter_block,,h,1014,536870912,000000001B9724E0,30482272,30567196
tag_files\tag_groups.cpp,5852,48,132,bs codes,render_method_option_struct_definition,,h,1015,536870912,000000001B96CB90,30482320,30567328
tag_files\tag_groups.cpp,5852,48,132,bs codes,shader_struct_definition,,h,1016,536870912,000000001B96D640,30482368,30567460
tag_files\tag_groups.cpp,5852,176,260,bs codes,shader_struct_definition,,h,1017,536870912,000000001B9574B0,30482544,30567720
tag_files\tag_groups.cpp,5852,48,132,bs codes,shader_skin_struct_definition,,h,1018,536870912,000000001B96CCB0,30482592,30567852
tag_files\tag_groups.cpp,5852,176,260,bs codes,shader_skin_struct_definition,,h,1019,536870912,000000001B956A10,30482768,30568112
tag_files\tag_groups.cpp,5852,144,228,bs codes,render_method_template_pass_block,,h,1020,536870912,000000001B95FBF0,30482912,30568340
tag_files\tag_groups.cpp,5852,32,116,bs codes,render_method_template_constant_table_block,,h,1021,536870912,000000001B97E990,30482944,30568456
tag_files\tag_groups.cpp,5852,264,348,bs codes,render_method_template_platform_block,,h,1022,536870912,000000001B9814C0,30483208,30568804
tag_files\tag_groups.cpp,5852,288,372,bs codes,render_method_template_struct_definition,,h,1023,536870912,000000001B982A70,30483496,30569176
tag_files\tag_groups.cpp,5852,32,116,bs codes,material_type_struct,,h,1024,536870912,000000001B97D890,30483528,30569292
tag_files\tag_groups.cpp,5852,144,228,bs codes,shader_terrain_struct_definition,,h,1025,536870912,000000001B960730,30483672,30569520
tag_files\tag_groups.cpp,5852,272,356,bs codes,shader_terrain_struct_definition,,h,1026,536870912,000000001B981630,30483944,30569876
tag_files\tag_groups.cpp,5852,40,124,bs codes,shader_water_struct_definition,,h,1027,536870912,000000001B96BCF0,30483984,30570000
tag_files\tag_groups.cpp,5852,168,252,bs codes,shader_water_struct_definition,,h,1028,536870912,000000001B955A20,30484152,30570252
tag_files\tag_groups.cpp,5852,56,140,bs codes,layer_bitmaps,,h,1029,536870912,000000001B97EF00,30484208,30570392
tag_files\tag_groups.cpp,5852,88,172,bs codes,replace_material,,h,1030,536870912,000000001B978170,30484296,30570564
tag_files\tag_groups.cpp,5852,88,172,bs codes,replace_bitmaps,,h,1031,536870912,000000001B977030,30484384,30570736
tag_files\tag_groups.cpp,5852,56,140,bs codes,replace_params_material,,h,1032,536870912,000000001B97FF40,30484440,30570876
tag_files\tag_groups.cpp,5852,56,140,bs codes,real_vector4d_skins,,h,1033,536870912,000000001B97F540,30484496,30571016
tag_files\tag_groups.cpp,5852,64,148,bs codes,replace_params,,h,1034,536870912,000000001B97FFE0,30484560,30571164
tag_files\tag_groups.cpp,5852,224,308,bs codes,render_skins_object,,h,1035,536870912,000000001B96B340,30484784,30571472
tag_files\tag_groups.cpp,5852,48,132,bs codes,render_skins_object_globals_struct_definition,,h,1036,536870912,000000001B96D6D0,30484832,30571604
tag_files\tag_groups.cpp,5852,200,284,bs codes,render_water_ripple_struct_definition,,h,1037,536870912,000000001B972150,30485032,30571888
tag_files\tag_groups.cpp,5852,40,124,bs codes,faux_data_cluster_data,,h,1038,536870912,000000001B96C170,30485072,30572012
tag_files\tag_groups.cpp,5852,40,124,bs codes,faux_data_instance_data,,h,1039,536870912,000000001B96C320,30485112,30572136
tag_files\tag_groups.cpp,5852,120,204,bs codes,faux_data_block_data,,h,1040,536870912,000000001B984140,30485232,30572340
tag_files\tag_groups.cpp,5852,56,140,bs codes,faux_data_object_data,,h,1041,536870912,000000001B97EFA0,30485288,30572480
tag_files\tag_groups.cpp,5852,32,116,bs codes,faux_data_lightprobe_terms,,h,1042,536870912,000000001B97E690,30485320,30572596
tag_files\tag_groups.cpp,5852,152,236,bs codes,faux_data_lightprobe_value,,h,1043,536870912,000000001B94CCA0,30485472,30572832
tag_files\tag_groups.cpp,5852,88,172,bs codes,faux_data_airprobe_lightgroup_value,,h,1044,536870912,000000001B977AB0,30485560,30573004
tag_files\tag_groups.cpp,5852,56,140,bs codes,faux_data_scenery_probe_lightgroup_value,,h,1045,536870912,000000001B97EB40,30485616,30573144
tag_files\tag_groups.cpp,5852,64,148,bs codes,faux_data_device_probe_lightgroup_value,,h,1046,536870912,000000001B97EDC0,30485680,30573292
tag_files\tag_groups.cpp,5852,64,148,bs codes,faux_data_device_probes_lightgroup_value,,h,1047,536870912,000000001B980120,30485744,30573440
tag_files\tag_groups.cpp,5852,224,308,bs codes,scenario_lightmap_match_probe_block,,h,1048,536870912,000000001B969900,30485968,30573748
tag_files\tag_groups.cpp,5852,280,364,bs codes,faux_data_lightmap_group_data,,h,1049,536870912,000000001B984C00,30486248,30574112
tag_files\tag_groups.cpp,5852,32,116,bs codes,faux_data_global_cluster_instance_data,,h,1050,536870912,000000001B97D910,30486280,30574228
tag_files\tag_groups.cpp,5852,64,148,bs codes,faux_data_global_cluster_data,,h,1051,536870912,000000001B9801C0,30486344,30574376
tag_files\tag_groups.cpp,5852,32,116,bs codes,faux_data_global_instance_definition_data,,h,1052,536870912,000000001B97E010,30486376,30574492
tag_files\tag_groups.cpp,5852,128,212,bs codes,faux_data_global_instance_data,,h,1053,536870912,000000001B983880,30486504,30574704
tag_files\tag_groups.cpp,5852,64,148,bs codes,faux_data_global_material_data,,h,1054,536870912,000000001B97F5E0,30486568,30574852
tag_files\tag_groups.cpp,5852,168,252,bs codes,faux_data_bsp_global_data,,h,1055,536870912,000000001B955B30,30486736,30575104
tag_files\tag_groups.cpp,5852,264,348,bs codes,faux_data_airprobe_value,,h,1056,536870912,000000001B982770,30487000,30575452
tag_files\tag_groups.cpp,5852,232,316,bs codes,faux_data_scenery_probe_value,,h,1057,536870912,000000001B962540,30487232,30575768
tag_files\tag_groups.cpp,5852,240,324,bs codes,faux_data_device_machine_probe_value,,h,1058,536870912,000000001B9627E0,30487472,30576092
tag_files\tag_groups.cpp,5852,112,196,bs codes,faux_data_device_machine_probes_value,,h,1059,536870912,000000001B952500,30487584,30576288
tag_files\tag_groups.cpp,5852,160,244,bs codes,scenario_faux_data_struct_definition,,h,1060,536870912,000000001B94C0A0,30487744,30576532
tag_files\tag_groups.cpp,5852,56,140,bs codes,scenario_lightmap_bsp_data_reference_block,,h,1061,536870912,000000001B97FEA0,30487800,30576672
tag_files\tag_groups.cpp,5852,264,348,bs codes,obsolete_scenario_lightmap_bsp_data,,h,1062,536870912,000000001B982490,30488064,30577020
tag_files\tag_groups.cpp,5852,176,260,bs codes,scenario_lightmap_block_struct,,h,1063,536870912,000000001B955C40,30488240,30577280
tag_files\tag_groups.cpp,5852,56,140,bs codes,structure_seam_identifier_struct,,h,1064,536870912,000000001B97FA40,30488296,30577420
tag_files\tag_groups.cpp,5852,32,116,bs codes,structure_seam_edge_mapping_block,,h,1065,536870912,000000001B97D390,30488328,30577536
tag_files\tag_groups.cpp,5852,56,140,bs codes,structure_seam_cluster_mapping_block,,h,1066,536870912,000000001B97FE00,30488384,30577676
tag_files\tag_groups.cpp,5852,88,172,bs codes,structure_seam_mapping_block,,h,1067,536870912,000000001B977E70,30488472,30577848
tag_files\tag_groups.cpp,5852,40,124,bs codes,structure_edge_to_seam_edge_mapping_block,,h,1068,536870912,000000001B96C560,30488512,30577972
tag_files\tag_groups.cpp,5852,88,172,bs codes,structure_collision_materials_block,,h,1069,536870912,000000001B977C30,30488600,30578144
tag_files\tag_groups.cpp,5852,32,116,bs codes,structure_bsp_leaf_block,,h,1070,536870912,000000001B97E810,30488632,30578260
tag_files\tag_groups.cpp,5852,40,124,bs codes,structure_surface_small_block,,h,1071,536870912,000000001B96C5F0,30488672,30578384
tag_files\tag_groups.cpp,5852,40,124,bs codes,structure_surface_block,,h,1072,536870912,000000001B985B50,30488712,30578508
tag_files\tag_groups.cpp,5852,40,124,bs codes,structure_surface_to_triangle_mapping_block,,h,1073,536870912,000000001B9857F0,30488752,30578632
tag_files\tag_groups.cpp,5852,48,132,bs codes,structure_bsp_cluster_portal_vertex_block,,h,1074,536870912,000000001B9869F0,30488800,30578764
tag_files\tag_groups.cpp,5852,112,196,bs codes,structure_bsp_cluster_portal_block,,h,1075,536870912,000000001B9526A0,30488912,30578960
tag_files\tag_groups.cpp,5852,56,140,bs codes,structure_bsp_weather_polyhedron_plane_block,,h,1076,536870912,000000001B9803A0,30488968,30579100
tag_files\tag_groups.cpp,5852,80,164,bs codes,structure_bsp_weather_polyhedron_block,,h,1077,536870912,000000001B967AC0,30489048,30579264
tag_files\tag_groups.cpp,5852,88,172,bs codes,global_detail_object_cells_block,,h,1078,536870912,000000001B977570,30489136,30579436
tag_files\tag_groups.cpp,5852,64,148,bs codes,global_detail_object_block,,h,1079,536870912,000000001B980260,30489200,30579584
tag_files\tag_groups.cpp,5852,32,116,bs codes,global_detail_object_counts_block,,h,1080,536870912,000000001B97D410,30489232,30579700
tag_files\tag_groups.cpp,5852,56,140,bs codes,global_z_reference_vector_block,,h,1081,536870912,000000001B97F680,30489288,30579840
tag_files\tag_groups.cpp,5852,136,220,bs codes,structure_bsp_detail_object_data_block,,h,1082,536870912,000000001B961720,30489424,30580060
tag_files\tag_groups.cpp,5852,32,116,bs codes,structure_bsp_cluster_portal_index_block,,h,1083,536870912,000000001B97E090,30489456,30580176
tag_files\tag_groups.cpp,5852,88,172,bs codes,cluster_instanced_geometry_shape_struct,,h,1084,536870912,000000001B978230,30489544,30580348
tag_files\tag_groups.cpp,5852,64,148,bs codes,mopp_bv_tree_shape_struct,,h,1085,536870912,000000001B980300,30489608,30580496
tag_files\tag_groups.cpp,5852,88,172,bs codes,collision_instanced_geometry_struct,,h,1086,536870912,000000001B978770,30489696,30580668
tag_files\tag_groups.cpp,5852,32,116,bs codes,seam_indices_block_definition,,h,1087,536870912,000000001B97DC90,30489728,30580784
tag_files\tag_groups.cpp,5852,32,116,bs codes,model_start_index_block,,h,1088,536870912,000000001B97D110,30489760,30580900
tag_files\tag_groups.cpp,5852,160,244,bs codes,decorator_runtime_cluster_block,,h,1089,536870912,000000001B94B4A0,30489920,30581144
tag_files\tag_groups.cpp,5852,40,124,bs codes,pvs_bound_object_identifiers_block,,h,1090,536870912,000000001B986450,30489960,30581268
tag_files\tag_groups.cpp,5852,40,124,bs codes,scenario_object_reference_struct,,h,1091,536870912,000000001B985880,30490000,30581392
tag_files\tag_groups.cpp,5852,40,124,bs codes,pvs_bound_object_references_block,,h,1092,536870912,000000001B985E20,30490040,30581516
tag_files\tag_groups.cpp,5852,64,148,bs codes,structure_cluster_cubemap,,h,1093,536870912,000000001B97FD60,30490104,30581664
tag_files\tag_groups.cpp,5852,384,468,bs codes,structure_bsp_cluster_block,,h,1094,536870912,000000001B9124B0,30490488,30582132
tag_files\tag_groups.cpp,5852,32,116,bs codes,structure_bsp_sky_owner_cluster_block,,h,1095,536870912,000000001B97E210,30490520,30582248
tag_files\tag_groups.cpp,5852,72,156,bs codes,structure_bsp_conveyor_surface_block,,h,1096,536870912,000000001B968F60,30490592,30582404
tag_files\tag_groups.cpp,5852,32,116,bs codes,supported_bitfield,,h,1097,536870912,000000001B97E290,30490624,30582520
tag_files\tag_groups.cpp,5852,64,148,bs codes,breakable_surface_set_block,,h,1098,536870912,000000001B97F040,30490688,30582668
tag_files\tag_groups.cpp,5852,48,132,bs codes,sector_block,,h,1099,536870912,000000001B9850A0,30490736,30582800
tag_files\tag_groups.cpp,5852,88,172,bs codes,sector_link_block,,h,1100,536870912,000000001B978470,30490824,30582972
tag_files\tag_groups.cpp,5852,32,116,bs codes,ref_block,,h,1101,536870912,000000001B97D190,30490856,30583088
tag_files\tag_groups.cpp,5852,64,148,bs codes,sector_bsp2d_nodes_block,,h,1102,536870912,000000001B980440,30490920,30583236
tag_files\tag_groups.cpp,5852,48,132,bs codes,sector_vertex_block,,h,1103,536870912,000000001B985910,30490968,30583368
tag_files\tag_groups.cpp,5852,80,164,bs codes,environment_object_bsp_refs,,h,1104,536870912,000000001B968930,30491048,30583532
tag_files\tag_groups.cpp,5852,80,164,bs codes,environment_object_refs,,h,1105,536870912,000000001B9692D0,30491128,30583696
tag_files\tag_groups.cpp,5852,72,156,bs codes,pathfinding_hints_block,,h,1106,536870912,000000001B988330,30491200,30583852
tag_files\tag_groups.cpp,5852,40,124,bs codes,instanced_geometry_reference_block,,h,1107,536870912,000000001B986CC0,30491240,30583976
tag_files\tag_groups.cpp,5852,32,116,bs codes,giant_pathfinding_data_block,,h,1108,536870912,000000001B97CE90,30491272,30584092
tag_files\tag_groups.cpp,5852,32,116,bs codes,pf_seam_link_block,,h,1109,536870912,000000001B97E890,30491304,30584208
tag_files\tag_groups.cpp,5852,48,132,bs codes,pf_seam_block,,h,1110,536870912,000000001B9856D0,30491352,30584340
tag_files\tag_groups.cpp,5852,40,124,bs codes,pf_jump_index_block,,h,1111,536870912,000000001B985370,30491392,30584464
tag_files\tag_groups.cpp,5852,72,156,bs codes,pf_jump_seam_block,,h,1112,536870912,000000001B987200,30491464,30584620
tag_files\tag_groups.cpp,5852,40,124,bs codes,pf_door_block,,h,1113,536870912,000000001B9859A0,30491504,30584744
tag_files\tag_groups.cpp,5852,320,404,bs codes,pathfinding_data_block,,h,1114,536870912,000000001B988DA0,30491824,30585148
tag_files\tag_groups.cpp,5852,32,116,bs codes,structure_bsp_pathfinding_edges_block,,h,1115,536870912,000000001B97CC90,30491856,30585264
tag_files\tag_groups.cpp,5852,88,172,bs codes,structure_bsp_marker_block,,h,1116,536870912,000000001B977B70,30491944,30585436
tag_files\tag_groups.cpp,5852,56,140,bs codes,structure_bsp_marker_light_palette,,h,1117,536870912,000000001B97FC20,30492000,30585576
tag_files\tag_groups.cpp,5852,32,116,bs codes,structure_bsp_marker_light_index,,h,1118,536870912,000000001B97DA90,30492032,30585692
tag_files\tag_groups.cpp,5852,104,188,bs codes,structure_bsp_runtime_decal_block,,h,1119,536870912,000000001B952770,30492136,30585880
tag_files\tag_groups.cpp,5852,96,180,bs codes,structure_bsp_environment_object_palette_block,,h,1120,536870912,000000001B976970,30492232,30586060
tag_files\tag_groups.cpp,5852,136,220,bs codes,structure_bsp_environment_object_block,,h,1121,536870912,000000001B95FFB0,30492368,30586280
tag_files\tag_groups.cpp,5852,48,132,bs codes,map_leaf_face_vertex_block,,h,1122,536870912,000000001B984E60,30492416,30586412
tag_files\tag_groups.cpp,5852,56,140,bs codes,map_leaf_face_block,,h,1123,536870912,000000001B97F4A0,30492472,30586552
tag_files\tag_groups.cpp,5852,32,116,bs codes,map_leaf_connection_index_block,,h,1124,536870912,000000001B97CD10,30492504,30586668
tag_files\tag_groups.cpp,5852,72,156,bs codes,global_map_leaf_block,,h,1125,536870912,000000001B987E60,30492576,30586824
tag_files\tag_groups.cpp,5852,48,132,bs codes,leaf_connection_vertex_block,,h,1126,536870912,000000001B984DD0,30492624,30586956
tag_files\tag_groups.cpp,5852,80,164,bs codes,global_leaf_connection_block,,h,1127,536870912,000000001B988AC0,30492704,30587120
tag_files\tag_groups.cpp,5852,312,396,bs codes,structure_bsp_instanced_geometry_instances_block,,h,1128,536870912,000000001B988F40,30493016,30587516
tag_files\tag_groups.cpp,5852,216,300,bs codes,instanced_geometry_instance_fields_v2,,h,1129,536870912,000000001B96B0C0,30493232,30587816
tag_files\tag_groups.cpp,5852,216,300,bs codes,instanced_geometry_instance_fields_v2,,h,1130,536870912,000000001B96B200,30493448,30588116
tag_files\tag_groups.cpp,5852,56,140,bs codes,runtime_decorator_set_block,,h,1131,536870912,000000001B97F720,30493504,30588256
tag_files\tag_groups.cpp,5852,32,116,bs codes,structure_sound_cluster_portal_designators,,h,1132,536870912,000000001B97D210,30493536,30588372
tag_files\tag_groups.cpp,5852,32,116,bs codes,structure_sound_cluster_interior_cluster_indices,,h,1133,536870912,000000001B97DA10,30493568,30588488
tag_files\tag_groups.cpp,5852,88,172,bs codes,structure_bsp_sound_cluster_block,,h,1134,536870912,000000001B9770F0,30493656,30588660
tag_files\tag_groups.cpp,5852,72,156,bs codes,transparent_planes_block,,h,1135,536870912,000000001B987F10,30493728,30588816
tag_files\tag_groups.cpp,5852,104,188,bs codes,structure_bsp_debug_info_render_line_block,,h,1136,536870912,000000001B952C50,30493832,30589004
tag_files\tag_groups.cpp,5852,32,116,bs codes,structure_bsp_debug_info_indices_block,,h,1137,536870912,000000001B97D990,30493864,30589120
tag_files\tag_groups.cpp,5852,168,252,bs codes,structure_bsp_cluster_debug_info_block,,h,1138,536870912,000000001B9566E0,30494032,30589372
tag_files\tag_groups.cpp,5852,120,204,bs codes,structure_bsp_fog_plane_debug_info_block,,h,1139,536870912,000000001B9837A0,30494152,30589576
tag_files\tag_groups.cpp,5852,144,228,bs codes,structure_bsp_fog_zone_debug_info_block,,h,1140,536870912,000000001B961810,30494296,30589804
tag_files\tag_groups.cpp,5852,104,188,bs codes,structure_bsp_debug_info_block,,h,1141,536870912,000000001B9893A0,30494400,30589992
tag_files\tag_groups.cpp,5852,104,188,bs codes,breakable_surface_key_table_block,,h,1142,536870912,000000001B98A8C0,30494504,30590180
tag_files\tag_groups.cpp,5852,152,236,bs codes,global_structure_physics_struct,,h,1143,536870912,000000001B94B6A0,30494656,30590416
tag_files\tag_groups.cpp,5852,152,236,bs codes,structure_physics_struct_fields_v1,,h,1144,536870912,000000001B94BCA0,30494808,30590652
tag_files\tag_groups.cpp,5852,32,116,bs codes,door_encoded_pas_block,,h,1145,536870912,000000001B97E590,30494840,30590768
tag_files\tag_groups.cpp,5852,32,116,bs codes,cluster_door_portal_encoded_pas_block,,h,1146,536870912,000000001B97D290,30494872,30590884
tag_files\tag_groups.cpp,5852,32,116,bs codes,ai_deafening_encoded_pas_block,,h,1147,536870912,000000001B97E490,30494904,30591000
tag_files\tag_groups.cpp,5852,32,116,bs codes,encoded_cluster_distances_block,,h,1148,536870912,000000001B97D510,30494936,30591116
tag_files\tag_groups.cpp,5852,32,116,bs codes,occluder_to_machine_door_mapping,,h,1149,536870912,000000001B97DF90,30494968,30591232
tag_files\tag_groups.cpp,5852,168,252,bs codes,structure_bsp_audibility_block,,h,1150,536870912,000000001B98B250,30495136,30591484
tag_files\tag_groups.cpp,5852,48,132,bs codes,structure_bsp_fake_lightprobes_block,,h,1151,536870912,000000001B9864E0,30495184,30591616
tag_files\tag_groups.cpp,5852,72,156,bs codes,widget_reference_block,,h,1152,536870912,000000001B9872B0,30495256,30591772
tag_files\tag_groups.cpp,5852,216,300,bs codes,global_collision_bsp_block,,h,1153,536870912,000000001B96A940,30495472,30592072
tag_files\tag_groups.cpp,5852,48,132,bs codes,large_bsp3d_nodes_block,,h,1154,536870912,000000001B986840,30495520,30592204
tag_files\tag_groups.cpp,5852,48,132,bs codes,large_leaves_block,,h,1155,536870912,000000001B984EF0,30495568,30592336
tag_files\tag_groups.cpp,5852,40,124,bs codes,large_bsp2d_references_block,,h,1156,536870912,000000001B985760,30495608,30592460
tag_files\tag_groups.cpp,5852,64,148,bs codes,large_bsp2d_nodes_block,,h,1157,536870912,000000001B97F7C0,30495672,30592608
tag_files\tag_groups.cpp,5852,80,164,bs codes,large_surfaces_block,,h,1158,536870912,000000001B9878E0,30495752,30592772
tag_files\tag_groups.cpp,5852,72,156,bs codes,large_edges_block,,h,1159,536870912,000000001B987150,30495824,30592928
tag_files\tag_groups.cpp,5852,64,148,bs codes,large_vertices_block,,h,1160,536870912,000000001B9806C0,30495888,30593076
tag_files\tag_groups.cpp,5852,216,300,bs codes,global_large_collision_bsp_block,,h,1161,536870912,000000001B969F40,30496104,30593376
tag_files\tag_groups.cpp,5852,248,332,bs codes,structure_bsp_instanced_geometry_definition_block,,h,1162,536870912,000000001B95F240,30496352,30593708
tag_files\tag_groups.cpp,5852,120,204,bs codes,structure_bsp_resource_struct,,h,1163,536870912,000000001B983C00,30496472,30593912
tag_files\tag_groups.cpp,5852,40,124,bs codes,structure_bsp_raw_resources,,h,1164,536870912,000000001B986570,30496512,30594036
tag_files\tag_groups.cpp,5852,40,124,bs codes,structure_bsp_tag_resources_struct,,h,1165,536870912,000000001B9868D0,30496552,30594160
tag_files\tag_groups.cpp,5852,120,204,bs codes,structure_bsp_cache_file_tag_resources_struct,,h,1166,536870912,000000001B9835E0,30496672,30594364
tag_files\tag_groups.cpp,5852,88,172,bs codes,structure_bsp_resource_interface,,h,1167,536870912,000000001B976A30,30496760,30594536
tag_files\tag_groups.cpp,5852,1224,1308,bs codes,scenario_structure_bsp_block_struct,,h,1168,536870912,000000001B98D100,30497984,30595844
tag_files\tag_groups.cpp,5852,1224,1308,bs codes,scenario_structure_bsp_v0_block_struct,,h,1169,536870912,000000001B98D630,30499208,30597152
tag_files\tag_groups.cpp,5852,72,156,bs codes,scenery_group,,h,1170,536870912,000000001B9881D0,30499280,30597308
tag_files\tag_groups.cpp,5852,584,668,bs codes,scenery_group,,h,1171,536870912,000000001B98DB60,30499864,30597976
tag_files\tag_groups.cpp,5852,584,668,bs codes,scenery_fields_v2,,h,1172,536870912,000000001B98DE10,30500448,30598644
tag_files\tag_groups.cpp,5852,56,140,bs codes,scenery_fields_v1,,h,1173,536870912,000000001B97FAE0,30500504,30598784
tag_files\tag_groups.cpp,5852,56,140,bs codes,datasource_definition_block,,h,1174,536870912,000000001B97EE60,30500560,30598924
tag_files\tag_groups.cpp,5852,280,364,bs codes,group_widget_block,,h,1175,536870912,000000001B98E0C0,30500840,30599288
tag_files\tag_groups.cpp,5852,56,140,bs codes,button_key_block,,h,1176,536870912,000000001B97F0E0,30500896,30599428
tag_files\tag_groups.cpp,5852,384,468,bs codes,gui_screen_widget_definition_struct_definition,,h,1177,536870912,000000001B912870,30501280,30599896
tag_files\tag_groups.cpp,5852,72,156,bs codes,scenario_sky_reference_block,,h,1178,536870912,000000001B986F40,30501352,30600052
tag_files\tag_groups.cpp,5852,32,116,bs codes,scenario_zone_set_bsp_checksum_block,,h,1179,536870912,000000001B97DE10,30501384,30600168
tag_files\tag_groups.cpp,5852,32,116,bs codes,scenario_zone_set_cluster_pvs_bit_vector_block,,h,1180,536870912,000000001B97CA90,30501416,30600284
tag_files\tag_groups.cpp,5852,48,132,bs codes,scenario_zone_set_bsp_bits_block,,h,1181,536870912,000000001B984F80,30501464,30600416
tag_files\tag_groups.cpp,5852,48,132,bs codes,scenario_zone_set_cluster_pvs_block,,h,1182,536870912,000000001B985FD0,30501512,30600548
tag_files\tag_groups.cpp,5852,32,116,bs codes,scenario_zone_set_cluster_sky_indices_block,,h,1183,536870912,000000001B97E110,30501544,30600664
tag_files\tag_groups.cpp,5852,32,116,bs codes,scenario_zone_set_multiple_skies_visible_bit_vector_block,,h,1184,536870912,000000001B97CB10,30501576,30600780
tag_files\tag_groups.cpp,5852,32,116,bs codes,cluster_audio_bit_vector_block,,h,1185,536870912,000000001B97E310,30501608,30600896
tag_files\tag_groups.cpp,5852,32,116,bs codes,cluster_audio_cluster_indices_block,,h,1186,536870912,000000001B97D310,30501640,30601012
tag_files\tag_groups.cpp,5852,48,132,bs codes,cluster_audio_cluster_neighbors_block,,h,1187,536870912,000000001B9851C0,30501688,30601144
tag_files\tag_groups.cpp,5852,192,276,bs codes,scenario_zone_set_bsp_pvs_block,,h,1188,536870912,000000001B93D660,30501880,30601420
tag_files\tag_groups.cpp,5852,56,140,bs codes,structure_device_portal_association_block,,h,1189,536870912,000000001B97F860,30501936,30601560
tag_files\tag_groups.cpp,5852,32,116,bs codes,game_portal_to_portal_mapping_block,,h,1190,536870912,000000001B97CB90,30501968,30601676
tag_files\tag_groups.cpp,5852,72,156,bs codes,structure_portal_device_mapping_block,,h,1191,536870912,000000001B9883E0,30502040,30601832
tag_files\tag_groups.cpp,5852,120,204,bs codes,scenario_zone_set_pvs_block,,h,1192,536870912,000000001B982E00,30502160,30602036
tag_files\tag_groups.cpp,5852,32,116,bs codes,door_encoded_pas_block,,h,1193,536870912,000000001B97CC10,30502192,30602152
tag_files\tag_groups.cpp,5852,32,116,bs codes,room_door_portal_encoded_pas_block,,h,1194,536870912,000000001B97E710,30502224,30602268
tag_files\tag_groups.cpp,5852,32,116,bs codes,ai_deafening_encoded_pas_block,,h,1195,536870912,000000001B97DB90,30502256,30602384
tag_files\tag_groups.cpp,5852,32,116,bs codes,encoded_room_distances_block,,h,1196,536870912,000000001B97DC10,30502288,30602500
tag_files\tag_groups.cpp,5852,40,124,bs codes,game_portal_to_door_occluder_block,,h,1197,536870912,000000001B986BA0,30502328,30602624
tag_files\tag_groups.cpp,5852,40,124,bs codes,bsp_cluster_to_room_bounds,,h,1198,536870912,000000001B985490,30502368,30602748
tag_files\tag_groups.cpp,5852,32,116,bs codes,bsp_cluster_to_room_indices,,h,1199,536870912,000000001B97D790,30502400,30602864
tag_files\tag_groups.cpp,5852,224,308,bs codes,game_audibility_block,,h,1200,536870912,000000001B96A080,30502624,30603172
tag_files\tag_groups.cpp,5852,112,196,bs codes,scenario_zone_set_block,,h,1201,536870912,000000001B98A0A0,30502736,30603368
tag_files\tag_groups.cpp,5852,48,132,bs codes,scenario_lighting_zone_set_block,,h,1202,536870912,000000001B985BE0,30502784,30603500
tag_files\tag_groups.cpp,5852,32,116,bs codes,scenario_campaign_player_representation_names_block,,h,1203,536870912,000000001B97E910,30502816,30603616
tag_files\tag_groups.cpp,5852,64,148,bs codes,scenario_giant_datum_struct,,h,1204,536870912,000000001B9804E0,30502880,30603764
tag_files\tag_groups.cpp,5852,104,188,bs codes,scenario_giant_block,,h,1205,536870912,000000001B989470,30502984,30603952
tag_files\tag_groups.cpp,5852,56,140,bs codes,scenario_giant_palette_block,,h,1206,536870912,000000001B97F180,30503040,30604092
tag_files\tag_groups.cpp,5852,80,164,bs codes,map_variant_vehicle_palette_block,,h,1207,536870912,000000001B988540,30503120,30604256
tag_files\tag_groups.cpp,5852,80,164,bs codes,map_variant_weapon_palette_block,,h,1208,536870912,000000001B987360,30503200,30604420
tag_files\tag_groups.cpp,5852,80,164,bs codes,map_variant_equipment_palette_block,,h,1209,536870912,000000001B987410,30503280,30604584
tag_files\tag_groups.cpp,5852,80,164,bs codes,map_variant_scenery_palette_block,,h,1210,536870912,000000001B9888B0,30503360,30604748
tag_files\tag_groups.cpp,5852,80,164,bs codes,map_variant_teleporter_palette_block,,h,1211,536870912,000000001B988A10,30503440,30604912
tag_files\tag_groups.cpp,5852,80,164,bs codes,map_variant_goal_palette_block,,h,1212,536870912,000000001B988280,30503520,30605076
tag_files\tag_groups.cpp,5852,80,164,bs codes,map_variant_spawn_objects_palette_block,,h,1213,536870912,000000001B987AF0,30503600,30605240
tag_files\tag_groups.cpp,5852,64,148,bs codes,scenario_soft_ceilings_block,,h,1214,536870912,000000001B980580,30503664,30605388
tag_files\tag_groups.cpp,5852,192,276,bs codes,scenario_profiles_block,,h,1215,536870912,000000001B93C340,30503856,30605664
tag_files\tag_groups.cpp,5852,80,164,bs codes,scenario_players_block,,h,1216,536870912,000000001B988490,30503936,30605828
tag_files\tag_groups.cpp,5852,56,140,bs codes,scenario_zone_set_switch_trigger_volume_block,,h,1217,536870912,000000001B97F220,30503992,30605968
tag_files\tag_groups.cpp,5852,64,148,bs codes,player_spawn_influencer_block,,h,1218,536870912,000000001B980620,30504056,30606116
tag_files\tag_groups.cpp,5852,64,148,bs codes,netgame_goal_influencer_block,,h,1219,536870912,000000001B980760,30504120,30606264
tag_files\tag_groups.cpp,5852,56,140,bs codes,scenario_detail_object_collection_palette_block,,h,1220,536870912,000000001B97FCC0,30504176,30606404
tag_files\tag_groups.cpp,5852,112,196,bs codes,user_hint_line_segment_block,,h,1221,536870912,000000001B989200,30504288,30606600
tag_files\tag_groups.cpp,5852,208,292,bs codes,user_hint_parallelogram_block,,h,1222,536870912,000000001B970D20,30504496,30606892
tag_files\tag_groups.cpp,5852,56,140,bs codes,user_hint_jump_block,,h,1223,536870912,000000001B980800,30504552,30607032
tag_files\tag_groups.cpp,5852,56,140,bs codes,user_hint_climb_block,,h,1224,536870912,000000001B97EC80,30504608,30607172
tag_files\tag_groups.cpp,5852,96,180,bs codes,user_hint_well_point_block,,h,1225,536870912,000000001B977CF0,30504704,30607352
tag_files\tag_groups.cpp,5852,56,140,bs codes,user_hint_well_block,,h,1226,536870912,000000001B9808A0,30504760,30607492
tag_files\tag_groups.cpp,5852,48,132,bs codes,user_hint_flight_point_block,,h,1227,536870912,000000001B9855B0,30504808,30607624
tag_files\tag_groups.cpp,5852,48,132,bs codes,user_hint_flight_block,,h,1228,536870912,000000001B986A80,30504856,30607756
tag_files\tag_groups.cpp,5852,80,164,bs codes,user_hint_sector_point_block,,h,1229,536870912,000000001B9874C0,30504936,30607920
tag_files\tag_groups.cpp,5852,48,132,bs codes,user_hint_giant_sector_block,,h,1230,536870912,000000001B986960,30504984,30608052
tag_files\tag_groups.cpp,5852,40,124,bs codes,user_hint_giant_rail_block,,h,1231,536870912,000000001B985F40,30505024,30608176
tag_files\tag_groups.cpp,5852,72,156,bs codes,user_hint_giant_block,,h,1232,536870912,000000001B988C20,30505096,30608332
tag_files\tag_groups.cpp,5852,48,132,bs codes,user_hint_flood_sector_block,,h,1233,536870912,000000001B985A30,30505144,30608464
tag_files\tag_groups.cpp,5852,48,132,bs codes,user_hint_flood_block,,h,1234,536870912,000000001B986060,30505192,30608596
tag_files\tag_groups.cpp,5852,240,324,bs codes,user_hint_block,,h,1235,536870912,000000001B962150,30505432,30608920
tag_files\tag_groups.cpp,5852,48,132,bs codes,hs_script_parameters_block,,h,1236,536870912,000000001B986B10,30505480,30609052
tag_files\tag_groups.cpp,5852,80,164,bs codes,hs_scripts_block,,h,1237,536870912,000000001B9885F0,30505560,30609216
tag_files\tag_groups.cpp,5852,56,140,bs codes,hs_globals_block,,h,1238,536870912,000000001B97ED20,30505616,30609356
tag_files\tag_groups.cpp,5852,136,220,bs codes,scenario_cutscene_title_struct,,h,1239,536870912,000000001B9600A0,30505752,30609576
tag_files\tag_groups.cpp,5852,120,204,bs codes,scenario_cutscene_title_struct_v1,,h,1240,536870912,000000001B984220,30505872,30609780
tag_files\tag_groups.cpp,5852,56,140,bs codes,scenario_hs_source_reference_block,,h,1241,536870912,000000001B97F900,30505928,30609920
tag_files\tag_groups.cpp,5852,56,140,bs codes,scenario_ai_resource_reference_block,,h,1242,536870912,000000001B97F9A0,30505984,30610060
tag_files\tag_groups.cpp,5852,56,140,bs codes,scenario_resource_reference_block,,h,1243,536870912,000000001B97FB80,30506040,30610200
tag_files\tag_groups.cpp,5852,752,836,bs codes,scenario_split_resources_block_struct,,h,1244,536870912,000000001B98E240,30506792,30611036
tag_files\tag_groups.cpp,5852,104,188,bs codes,scenario_resources_block_struct,,h,1245,536870912,000000001B98A580,30506896,30611224
tag_files\tag_groups.cpp,5852,96,180,bs codes,old_scenario_resources_struct,,h,1246,536870912,000000001B976EB0,30506992,30611404
tag_files\tag_groups.cpp,5852,48,132,bs codes,hs_unit_seat_block,,h,1247,536870912,000000001B985400,30507040,30611536
tag_files\tag_groups.cpp,5852,32,116,bs codes,scenario_kill_trigger_volumes_block,,h,1248,536870912,000000001B97E510,30507072,30611652
tag_files\tag_groups.cpp,5852,32,116,bs codes,scenario_safe_zone_trigger_volumes_block,,h,1249,536870912,000000001B97D490,30507104,30611768
tag_files\tag_groups.cpp,5852,96,180,bs codes,hs_syntax_datum_block,,h,1250,536870912,000000001B9771B0,30507200,30611948
tag_files\tag_groups.cpp,5852,56,140,bs codes,scenario_acoustic_volume_block,,h,1251,536870912,000000001B980940,30507256,30612088
tag_files\tag_groups.cpp,5852,32,116,bs codes,object_salt_storage_array,,h,1252,536870912,000000001B97CD90,30507288,30612204
tag_files\tag_groups.cpp,5852,64,148,bs codes,dynamic_spawn_zone_overload_block,,h,1253,536870912,000000001B97EAA0,30507352,30612352
tag_files\tag_groups.cpp,5852,56,140,bs codes,static_spawn_zone_data_struct,,h,1254,536870912,000000001B97EBE0,30507408,30612492
tag_files\tag_groups.cpp,5852,104,188,bs codes,static_spawn_zone_block,,h,1255,536870912,000000001B98A650,30507512,30612680
tag_files\tag_groups.cpp,5852,120,204,bs codes,scenario_spawn_data_block,,h,1256,536870912,000000001B984AE0,30507632,30612884
tag_files\tag_groups.cpp,5852,56,140,bs codes,ai_scenario_mission_dialogue_block,,h,1257,536870912,000000001B97F2C0,30507688,30613024
tag_files\tag_groups.cpp,5852,80,164,bs codes,scenario_interpolator_block,,h,1258,536870912,000000001B987570,30507768,30613188
tag_files\tag_groups.cpp,5852,88,172,bs codes,scenario_screen_effect_reference_block,,h,1259,536870912,000000001B9786B0,30507856,30613360
tag_files\tag_groups.cpp,5852,56,140,bs codes,scenario_chocalate_mountain_references_block,,h,1260,536870912,000000001B97F360,30507912,30613500
tag_files\tag_groups.cpp,5852,72,156,bs codes,ai_reference_frame_block,,h,1261,536870912,000000001B987FC0,30507984,30613656
tag_files\tag_groups.cpp,5852,32,116,bs codes,biped_block_index_flags_block_struct,,h,1262,536870912,000000001B97CF90,30508016,30613772
tag_files\tag_groups.cpp,5852,32,116,bs codes,vehicle_block_index_flags_block_struct,,h,1263,536870912,000000001B97D590,30508048,30613888
tag_files\tag_groups.cpp,5852,32,116,bs codes,weapon_block_index_flags_block_struct,,h,1264,536870912,000000001B97E410,30508080,30614004
tag_files\tag_groups.cpp,5852,32,116,bs codes,equipment_block_index_flags_block_struct,,h,1265,536870912,000000001B97D610,30508112,30614120
tag_files\tag_groups.cpp,5852,32,116,bs codes,scenery_block_index_flags_block_struct,,h,1266,536870912,000000001B97E190,30508144,30614236
tag_files\tag_groups.cpp,5852,32,116,bs codes,machine_block_index_flags_block_struct,,h,1267,536870912,000000001B97CF10,30508176,30614352
tag_files\tag_groups.cpp,5852,32,116,bs codes,old_broken_designer_zone_machine_palette_index_struct,,h,1268,536870912,000000001B97D690,30508208,30614468
tag_files\tag_groups.cpp,5852,32,116,bs codes,terminal_block_index_flags_block_struct,,h,1269,536870912,000000001B97D010,30508240,30614584
tag_files\tag_groups.cpp,5852,32,116,bs codes,control_block_index_flags_block_struct,,h,1270,536870912,000000001B97D710,30508272,30614700
tag_files\tag_groups.cpp,5852,32,116,bs codes,sound_scenery_block_index_flags_block_struct,,h,1271,536870912,000000001B97D090,30508304,30614816
tag_files\tag_groups.cpp,5852,32,116,bs codes,crate_block_index_flags_block_struct,,h,1272,536870912,000000001B97E790,30508336,30614932
tag_files\tag_groups.cpp,5852,32,116,bs codes,creature_block_index_flags_block_struct,,h,1273,536870912,000000001B97D810,30508368,30615048
tag_files\tag_groups.cpp,5852,32,116,bs codes,giant_block_index_flags_block_struct,,h,1274,536870912,000000001B97E390,30508400,30615164
tag_files\tag_groups.cpp,5852,32,116,bs codes,effect_scenery_block_index_flags_block_struct,,h,1275,536870912,000000001B97DB10,30508432,30615280
tag_files\tag_groups.cpp,5852,32,116,bs codes,character_block_index_flags_block_struct,,h,1276,536870912,000000001B97DD10,30508464,30615396
tag_files\tag_groups.cpp,5852,32,116,bs codes,budget_reference_block_index_flags_block_struct,,h,1277,536870912,000000001B97DD90,30508496,30615512
tag_files\tag_groups.cpp,5852,400,484,bs codes,scenario_designer_zone_block,,h,1278,536870912,000000001B98E590,30508896,30615996
tag_files\tag_groups.cpp,5852,32,116,bs codes,scenario_zone_debugger_block_definition_struct,,h,1279,536870912,000000001B97DE90,30508928,30616112
tag_files\tag_groups.cpp,5852,64,148,bs codes,scenario_cinematic_lighting_palette_block,,h,1280,536870912,000000001B97F400,30508992,30616260
tag_files\tag_groups.cpp,5852,40,124,bs codes,campaign_metagame_scenario_bonuses_block,,h,1281,536870912,000000001B9860F0,30509032,30616384
tag_files\tag_groups.cpp,5852,56,140,bs codes,campaign_metagame_scenario_block,,h,1282,536870912,000000001B98F4F0,30509088,30616524
tag_files\tag_groups.cpp,5852,72,156,bs codes,soft_surfaces_definition_block,,h,1283,536870912,000000001B9886A0,30509160,30616680
tag_files\tag_groups.cpp,5852,56,140,bs codes,scenario_cortana_effect_block,,h,1284,536870912,000000001B98ED70,30509216,30616820
tag_files\tag_groups.cpp,5852,72,156,bs codes,scenario_airprobes_block,,h,1285,536870912,000000001B987620,30509288,30616976
tag_files\tag_groups.cpp,5852,56,140,bs codes,scenario_budget_references_block,,h,1286,536870912,000000001B98F270,30509344,30617116
tag_files\tag_groups.cpp,5852,48,132,bs codes,scenario_scavenger_hunt_object_block,,h,1287,536870912,000000001B986C30,30509392,30617248
tag_files\tag_groups.cpp,5852,3664,3748,bs codes,scenario_struct_definition,,h,1288,536870912,000000001B990B90,30513056,30620996
tag_files\tag_groups.cpp,5852,160,244,bs codes,structure_soft_ceiling_triangle_block,,h,1289,536870912,000000001B94B9A0,30513216,30621240
tag_files\tag_groups.cpp,5852,72,156,bs codes,structure_soft_ceiling_block,,h,1290,536870912,000000001B988070,30513288,30621396
tag_files\tag_groups.cpp,5852,32,116,bs codes,structure_water_groups_block,,h,1291,536870912,000000001B97DF10,30513320,30621512
tag_files\tag_groups.cpp,5852,56,140,bs codes,structure_water_instance_planes_block,,h,1292,536870912,000000001B98F310,30513376,30621652
tag_files\tag_groups.cpp,5852,96,180,bs codes,structure_water_instance_debug_triangles_block,,h,1293,536870912,000000001B976AF0,30513472,30621832
tag_files\tag_groups.cpp,5852,120,204,bs codes,structure_water_instances_block,,h,1294,536870912,000000001B982FC0,30513592,30622036
tag_files\tag_groups.cpp,5852,152,236,bs codes,global_structure_physics_design_struct,,h,1295,536870912,000000001B94BAA0,30513744,30622272
tag_files\tag_groups.cpp,5852,40,124,bs codes,structure_design_block_struct,,h,1296,536870912,000000001B985AC0,30513784,30622396
tag_files\tag_groups.cpp,5852,48,132,bs codes,scenario_required_resource_struct_definition,,h,1297,536870912,000000001B9852E0,30513832,30622528
tag_files\tag_groups.cpp,5852,40,124,bs codes,screen_effect_scalar_function_struct,,h,1298,536870912,000000001B986180,30513872,30622652
tag_files\tag_groups.cpp,5852,216,300,bs codes,single_screen_effect,,h,1299,536870912,000000001B9697C0,30514088,30622952
tag_files\tag_groups.cpp,5852,48,132,bs codes,area_screen_effect_struct_definition,,h,1300,536870912,000000001B985010,30514136,30623084
tag_files\tag_groups.cpp,5852,40,124,bs codes,platform_sound_override_mixbins_block,,h,1301,536870912,000000001B985130,30514176,30623208
tag_files\tag_groups.cpp,5852,56,140,bs codes,sound_playback_parameter_definition,,h,1302,536870912,000000001B990490,30514232,30623348
tag_files\tag_groups.cpp,5852,104,188,bs codes,platform_sound_filter_block,,h,1303,536870912,000000001B989AF0,30514336,30623536
tag_files\tag_groups.cpp,5852,72,156,bs codes,platform_sound_pitch_lfo_block,,h,1304,536870912,000000001B9876D0,30514408,30623692
tag_files\tag_groups.cpp,5852,88,172,bs codes,platform_sound_filter_lfo_block,,h,1305,536870912,000000001B977DB0,30514496,30623864
tag_files\tag_groups.cpp,5852,72,156,bs codes,sound_effect_component_block,,h,1306,536870912,000000001B987780,30514568,30624020
tag_files\tag_groups.cpp,5852,88,172,bs codes,sound_effect_override_parameters_block,,h,1307,536870912,000000001B977F30,30514656,30624192
tag_files\tag_groups.cpp,5852,48,132,bs codes,g_sound_effect_override_parameters_fields_v1,,h,1308,536870912,000000001B985C70,30514704,30624324
tag_files\tag_groups.cpp,5852,56,140,bs codes,sound_effect_overrides_block,,h,1309,536870912,000000001B98F630,30514760,30624464
tag_files\tag_groups.cpp,5852,168,252,bs codes,sound_effect_struct_definition,,h,1310,536870912,000000001B98C460,30514928,30624716
tag_files\tag_groups.cpp,5852,40,124,bs codes,sound_effect_playback_block,,h,1311,536870912,000000001B985D90,30514968,30624840
tag_files\tag_groups.cpp,5852,168,252,bs codes,platform_sound_playback_struct,,h,1312,536870912,000000001B98C130,30515136,30625092
tag_files\tag_groups.cpp,5852,48,132,bs codes,platform_sound_playback_block,,h,1313,536870912,000000001B986600,30515184,30625224
tag_files\tag_groups.cpp,5852,48,132,bs codes,sound_effect_collection_struct_definition,,h,1314,536870912,000000001B986210,30515232,30625356
tag_files\tag_groups.cpp,5852,168,252,bs codes,sound_propagation_definition_struct,,h,1315,536870912,000000001B98BAD0,30515400,30625608
tag_files\tag_groups.cpp,5852,40,124,bs codes,sound_global_propagation_block_struct,,h,1316,536870912,000000001B985250,30515440,30625732
tag_files\tag_groups.cpp,5852,352,436,bs codes,shield_impact_struct_definition,,h,1317,536870912,000000001B991A40,30515792,30626168
tag_files\tag_groups.cpp,5852,72,156,bs codes,text_value_pair_definition_struct_definition,,h,1318,536870912,000000001B988960,30515864,30626324
tag_files\tag_groups.cpp,5852,80,164,bs codes,gui_skin_definition_struct_definition,,h,1319,536870912,000000001B987830,30515944,30626488
tag_files\tag_groups.cpp,5852,72,156,bs codes,scenario_sky_references_resource_struct_definition,,h,1320,536870912,000000001B988800,30516016,30626644
tag_files\tag_groups.cpp,5852,360,444,bs codes,atmosphere_setting_block,,h,1321,536870912,000000001B991C00,30516376,30627088
tag_files\tag_groups.cpp,5852,64,148,bs codes,underwater_setting_block,,h,1322,536870912,000000001B990030,30516440,30627236
tag_files\tag_groups.cpp,5852,192,276,bs codes,sky_atm_parameters_struct_definition,,h,1323,536870912,000000001B93D780,30516632,30627512
tag_files\tag_groups.cpp,5852,40,124,bs codes,shared_cache_file_creation_date_array,,h,1324,536870912,000000001B985D00,30516672,30627636
tag_files\tag_groups.cpp,5852,56,140,bs codes,resource_owner_block_struct,,h,1325,536870912,000000001B98FD10,30516728,30627776
tag_files\tag_groups.cpp,5852,88,172,bs codes,cache_file_resource_type_identifier_block,,h,1326,536870912,000000001B977270,30516816,30627948
tag_files\tag_groups.cpp,5852,120,204,bs codes,shared_cache_file_original_location_block_struct,,h,1327,536870912,000000001B983EA0,30516936,30628152
tag_files\tag_groups.cpp,5852,32,116,bs codes,shared_cache_file_original_location_reference_block_struct,,h,1328,536870912,000000001B97E610,30516968,30628268
tag_files\tag_groups.cpp,5852,120,204,bs codes,shared_cache_file_new_location_block_struct,,h,1329,536870912,000000001B982C40,30517088,30628472
tag_files\tag_groups.cpp,5852,32,116,bs codes,new_location_indices_block_struct,,h,1330,536870912,000000001B9927A0,30517120,30628588
tag_files\tag_groups.cpp,5852,80,164,bs codes,per_map_unique_locations_block_struct,,h,1331,536870912,000000001B986FF0,30517200,30628752
tag_files\tag_groups.cpp,5852,432,516,bs codes,shared_cache_file_layout_block_struct,,h,1332,536870912,000000001B90C9D0,30517632,30629268
tag_files\tag_groups.cpp,5852,360,444,bs codes,sound_class_block,,h,1333,536870912,000000001B993DE0,30517992,30629712
tag_files\tag_groups.cpp,5852,48,132,bs codes,sound_classes_block_struct,,h,1334,536870912,000000001B985520,30518040,30629844
tag_files\tag_groups.cpp,5852,168,252,bs codes,sound_playback_parameters_struct,,h,1335,536870912,000000001B98B690,30518208,30630096
tag_files\tag_groups.cpp,5852,72,156,bs codes,sound_scale_modifiers_struct,,h,1336,536870912,000000001B987BA0,30518280,30630252
tag_files\tag_groups.cpp,5852,64,148,bs codes,sound_promotion_rule_block,,h,1337,536870912,000000001B9905D0,30518344,30630400
tag_files\tag_groups.cpp,5852,32,116,bs codes,sound_promotion_runtime_timer_block,,h,1338,536870912,000000001B9938A0,30518376,30630516
tag_files\tag_groups.cpp,5852,96,180,bs codes,sound_promotion_parameters_struct,,h,1339,536870912,000000001B9773F0,30518472,30630696
tag_files\tag_groups.cpp,5852,80,164,bs codes,sound_promotion_parameter_fields_v1,,h,1340,536870912,000000001B9870A0,30518552,30630860
tag_files\tag_groups.cpp,5852,88,172,bs codes,sound_permutation_chunk_block,,h,1341,536870912,000000001B977FF0,30518640,30631032
tag_files\tag_groups.cpp,5852,64,148,bs codes,g_sound_permutation_chunk_fields_v2,,h,1342,536870912,000000001B98F450,30518704,30631180
tag_files\tag_groups.cpp,5852,64,148,bs codes,g_sound_permutation_chunk_fields_v1,,h,1343,536870912,000000001B98FDB0,30518768,30631328
tag_files\tag_groups.cpp,5852,72,156,bs codes,sound_permutation_languages_block,,h,1344,536870912,000000001B987990,30518840,30631484
tag_files\tag_groups.cpp,5852,112,196,bs codes,sound_permutations_block,,h,1345,536870912,000000001B98A170,30518952,30631680
tag_files\tag_groups.cpp,5852,112,196,bs codes,sound_permutation_block_v2,,h,1346,536870912,000000001B989540,30519064,30631876
tag_files\tag_groups.cpp,5852,96,180,bs codes,sound_permutation_block_v1,,h,1347,536870912,000000001B976BB0,30519160,30632056
tag_files\tag_groups.cpp,5852,152,236,bs codes,sound_pitch_range_block,,h,1348,536870912,000000001B94C5A0,30519312,30632292
tag_files\tag_groups.cpp,5852,160,244,bs codes,simple_platform_sound_playback_struct,,h,1349,536870912,000000001B94BEA0,30519472,30632536
tag_files\tag_groups.cpp,5852,64,148,bs codes,sound_platform_sound_playback_block,,h,1350,536870912,000000001B98FEF0,30519536,30632684
tag_files\tag_groups.cpp,5852,48,132,bs codes,sound_permutation_marker_block,,h,1351,536870912,000000001B9863C0,30519584,30632816
tag_files\tag_groups.cpp,5852,72,156,bs codes,sound_xma2_seek_table_block,,h,1352,536870912,000000001B987A40,30519656,30632972
tag_files\tag_groups.cpp,5852,56,140,bs codes,facial_animation_key_block,,h,1353,536870912,000000001B98EE10,30519712,30633112
tag_files\tag_groups.cpp,5852,48,132,bs codes,facial_animation_curve_block,,h,1354,536870912,000000001B9862A0,30519760,30633244
tag_files\tag_groups.cpp,5852,80,164,bs codes,runtime_facial_animation_key_block,,h,1355,536870912,000000001B988CD0,30519840,30633408
tag_files\tag_groups.cpp,5852,104,188,bs codes,facial_animation_block,,h,1356,536870912,000000001B989130,30519944,30633596
tag_files\tag_groups.cpp,5852,280,364,bs codes,sound_permutation_raw_info_block,,h,1357,536870912,000000001B993FB0,30520224,30633960
tag_files\tag_groups.cpp,5852,48,132,bs codes,sound_definition_language_permutation_info_block,,h,1358,536870912,000000001B985EB0,30520272,30634092
tag_files\tag_groups.cpp,5852,280,364,bs codes,sound_permutation_raw_info_block_fields,,h,1359,536870912,000000001B994130,30520552,30634456
tag_files\tag_groups.cpp,5852,56,140,bs codes,sound_permutation_dialogue_info_block,,h,1360,536870912,000000001B990530,30520608,30634596
tag_files\tag_groups.cpp,5852,144,228,bs codes,sound_permutation_dialogue_info_new_block,,h,1361,536870912,000000001B960BE0,30520752,30634824
tag_files\tag_groups.cpp,5852,112,196,bs codes,sound_encoded_dialogue_section_block,,h,1362,536870912,000000001B9892D0,30520864,30635020
tag_files\tag_groups.cpp,5852,72,156,bs codes,sound_extra_info_block,,h,1363,536870912,000000001B988B70,30520936,30635176
tag_files\tag_groups.cpp,5852,32,116,bs codes,sound_permutation_language_info,,h,1364,536870912,000000001B992AA0,30520968,30635292
tag_files\tag_groups.cpp,5852,40,124,bs codes,sound_pitch_range_language_info,,h,1365,536870912,000000001B985640,30521008,30635416
tag_files\tag_groups.cpp,5852,80,164,bs codes,sound_language_info_block,,h,1366,536870912,000000001B988750,30521088,30635580
tag_files\tag_groups.cpp,5852,280,364,bs codes,sound_block_struct,,h,1367,536870912,000000001B9942B0,30521368,30635944
tag_files\tag_groups.cpp,5852,152,236,bs codes,sound_environment_group,,h,1368,536870912,000000001B94C1A0,30521520,30636180
tag_files\tag_groups.cpp,5852,152,236,bs codes,sound_environment_definition_fields,,h,1369,536870912,000000001B94C6A0,30521672,30636416
tag_files\tag_groups.cpp,5852,40,124,bs codes,sound_stereo_mix_struct,,h,1370,536870912,000000001B986330,30521712,30636540
tag_files\tag_groups.cpp,5852,40,124,bs codes,sound_surround_mix_struct,,h,1371,536870912,000000001B986690,30521752,30636664
tag_files\tag_groups.cpp,5852,40,124,bs codes,sound_center_mix_struct,,h,1372,536870912,000000001B986720,30521792,30636788
tag_files\tag_groups.cpp,5852,168,252,bs codes,sound_global_mix_struct,,h,1373,536870912,000000001B98BCF0,30521960,30637040
tag_files\tag_groups.cpp,5852,120,204,bs codes,sound_mix_struct_definition,,h,1374,536870912,000000001B983180,30522080,30637244
tag_files\tag_groups.cpp,5852,64,148,bs codes,sound_dialogue_constants_struct_definition,,h,1375,536870912,000000001B98FF90,30522144,30637392
tag_files\tag_groups.cpp,5852,72,156,bs codes,sound_scenery_struct_definition,,h,1376,536870912,000000001B987C50,30522216,30637548
tag_files\tag_groups.cpp,5852,584,668,bs codes,sound_scenery_struct_definition,,h,1377,536870912,000000001B994430,30522800,30638216
tag_files\tag_groups.cpp,5852,32,116,bs codes,scenario_structure_lighting_resource_struct_definition,,h,1378,536870912,000000001B993320,30522832,30638332
tag_files\tag_groups.cpp,5852,144,228,bs codes,structure_lighting_generic_light_definition_block,,h,1379,536870912,000000001B960CD0,30522976,30638560
tag_files\tag_groups.cpp,5852,104,188,bs codes,structure_lighting_generic_light_instance_block,,h,1380,536870912,000000001B98AB30,30523080,30638748
tag_files\tag_groups.cpp,5852,96,180,bs codes,structure_lighting_region_triangle_block,,h,1381,536870912,000000001B976D30,30523176,30638928
tag_files\tag_groups.cpp,5852,56,140,bs codes,structure_lighting_region_block,,h,1382,536870912,000000001B98F6D0,30523232,30639068
tag_files\tag_groups.cpp,5852,120,204,bs codes,structure_material_lighting_info_block,,h,1383,536870912,000000001B9844C0,30523352,30639272
tag_files\tag_groups.cpp,5852,128,212,bs codes,scenario_structure_lighting_info_struct_definition,,h,1384,536870912,000000001B984300,30523480,30639484
tag_files\tag_groups.cpp,5852,56,140,bs codes,structure_seam_original_vertex_block,,h,1385,536870912,000000001B98F590,30523536,30639624
tag_files\tag_groups.cpp,5852,48,132,bs codes,structure_seam_original_geometry_struct,,h,1386,536870912,000000001B9867B0,30523584,30639756
tag_files\tag_groups.cpp,5852,56,140,bs codes,structure_seam_final_planes_block,,h,1387,536870912,000000001B98E870,30523640,30639896
tag_files\tag_groups.cpp,5852,48,132,bs codes,structure_seam_final_points_block,,h,1388,536870912,000000001B995300,30523688,30640028
tag_files\tag_groups.cpp,5852,64,148,bs codes,structure_seam_final_triangles_block,,h,1389,536870912,000000001B98FB30,30523752,30640176
tag_files\tag_groups.cpp,5852,40,124,bs codes,structure_seam_final_edges_block,,h,1390,536870912,000000001B9958A0,30523792,30640300
tag_files\tag_groups.cpp,5852,120,204,bs codes,structure_seam_final_geometry_struct,,h,1391,536870912,000000001B982EE0,30523912,30640504
tag_files\tag_groups.cpp,5852,72,156,bs codes,structure_seam_block,,h,1392,536870912,000000001B987D00,30523984,30640660
tag_files\tag_groups.cpp,5852,80,164,bs codes,structure_seams_struct_definition,,h,1393,536870912,000000001B986DE0,30524064,30640824
tag_files\tag_groups.cpp,5852,32,116,bs codes,behavior_names_block,,h,1394,536870912,000000001B992020,30524096,30640940
tag_files\tag_groups.cpp,5852,160,244,bs codes,style_struct_definition,,h,1395,536870912,000000001B996A40,30524256,30641184
tag_files\tag_groups.cpp,5852,40,124,bs codes,tag_database_group_entry_block,,h,1396,536870912,000000001B995E40,30524296,30641308
tag_files\tag_groups.cpp,5852,32,116,bs codes,tag_database_entry_reference_block,,h,1397,536870912,000000001B9933A0,30524328,30641424
tag_files\tag_groups.cpp,5852,72,156,bs codes,tag_database_entry_block,,h,1398,536870912,000000001B987DB0,30524400,30641580
tag_files\tag_groups.cpp,5852,72,156,bs codes,tag_database_struct_definition,,h,1399,536870912,000000001B988120,30524472,30641736
tag_files\tag_groups.cpp,5852,752,836,bs codes,device_terminal_struct_definition,,h,1400,536870912,000000001B99A700,30525224,30642572
tag_files\tag_groups.cpp,5852,1576,1660,bs codes,device_terminal_struct_definition,,h,1401,536870912,000000001B99AA50,30526800,30644232
tag_files\tag_groups.cpp,5852,80,164,bs codes,camera_track_control_point_block,,h,1402,536870912,000000001B986E90,30526880,30644396
tag_files\tag_groups.cpp,5852,56,140,bs codes,camera_track_struct_definition,,h,1403,536870912,000000001B990670,30526936,30644536
tag_files\tag_groups.cpp,5852,112,196,bs codes,scenario_trigger_volumes_resource_struct_definition,,h,1404,536870912,000000001B989E30,30527048,30644732
tag_files\tag_groups.cpp,5852,32,116,bs codes,basic_block_use_once,,h,1405,536870912,000000001B992DA0,30527080,30644848
tag_files\tag_groups.cpp,5852,32,116,bs codes,basic_struct,,h,1406,536870912,000000001B993420,30527112,30644964
tag_files\tag_groups.cpp,5852,32,116,bs codes,basic_array,,h,1407,536870912,000000001B9937A0,30527144,30645080
tag_files\tag_groups.cpp,5852,40,124,bs codes,block_with_struct,,h,1408,536870912,000000001B995D20,30527184,30645204
tag_files\tag_groups.cpp,5852,32,116,bs codes,basic_block,,h,1409,536870912,000000001B9920A0,30527216,30645320
tag_files\tag_groups.cpp,5852,80,164,bs codes,complex_sub_block,,h,1410,536870912,000000001B99C730,30527296,30645484
tag_files\tag_groups.cpp,5852,72,156,bs codes,complex_block,,h,1411,536870912,000000001B99B290,30527368,30645640
tag_files\tag_groups.cpp,5852,104,188,bs codes,complex_struct,,h,1412,536870912,000000001B9897B0,30527472,30645828
tag_files\tag_groups.cpp,5852,88,172,bs codes,complex_array,,h,1413,536870912,000000001B9783B0,30527560,30646000
tag_files\tag_groups.cpp,5852,104,188,bs codes,motherload_struct,,h,1414,536870912,000000001B989610,30527664,30646188
tag_files\tag_groups.cpp,5852,976,1060,bs codes,test_tag_struct_definition,,h,1415,536870912,000000001B99D0F0,30528640,30647248
tag_files\tag_groups.cpp,5852,192,276,bs codes,gui_text_widget_definition_struct_definition,,h,1416,536870912,000000001B93D8A0,30528832,30647524
tag_files\tag_groups.cpp,5852,80,164,bs codes,sound_references_block,,h,1417,536870912,000000001B99CB50,30528912,30647688
tag_files\tag_groups.cpp,5852,88,172,bs codes,g_vocalization_sound_references_fields_v1,,h,1418,536870912,000000001B9774B0,30529000,30647860
tag_files\tag_groups.cpp,5852,96,180,bs codes,dialogue_group,,h,1419,536870912,000000001B9780B0,30529096,30648040
tag_files\tag_groups.cpp,5852,104,188,bs codes,g_dialogue_definition_fields_v1,,h,1420,536870912,000000001B98A240,30529200,30648228
tag_files\tag_groups.cpp,5852,48,132,bs codes,sound_gestalt_codec_block,,h,1421,536870912,000000001B996350,30529248,30648360
tag_files\tag_groups.cpp,5852,40,124,bs codes,sound_gestalt_playback_block,,h,1422,536870912,000000001B996470,30529288,30648484
tag_files\tag_groups.cpp,5852,40,124,bs codes,sound_gestalt_scale_block,,h,1423,536870912,000000001B996080,30529328,30648608
tag_files\tag_groups.cpp,5852,32,116,bs codes,sound_gestalt_import_names_block,,h,1424,536870912,000000001B993A20,30529360,30648724
tag_files\tag_groups.cpp,5852,80,164,bs codes,sound_gestalt_pitch_range_parameters_block,,h,1425,536870912,000000001B99BD90,30529440,30648888
tag_files\tag_groups.cpp,5852,64,148,bs codes,sound_gestalt_pitch_ranges_block,,h,1426,536870912,000000001B98FBD0,30529504,30649036
tag_files\tag_groups.cpp,5852,88,172,bs codes,sound_gestalt_permutations_block,,h,1427,536870912,000000001B9776F0,30529592,30649208
tag_files\tag_groups.cpp,5852,320,404,bs codes,sound_gestalt_permutation_languages_block_struct,,h,1428,536870912,000000001B99D520,30529912,30649612
tag_files\tag_groups.cpp,5852,40,124,bs codes,sound_gestalt_custom_playback_block,,h,1429,536870912,000000001B994730,30529952,30649736
tag_files\tag_groups.cpp,5852,32,116,bs codes,sound_gestalt_runtime_permutation_bit_vector_block,,h,1430,536870912,000000001B993B20,30529984,30649852
tag_files\tag_groups.cpp,5852,40,124,bs codes,sound_gestalt_promotions_block,,h,1431,536870912,000000001B9947C0,30530024,30649976
tag_files\tag_groups.cpp,5852,48,132,bs codes,sound_gestalt_extra_info_block,,h,1432,536870912,000000001B996590,30530072,30650108
tag_files\tag_groups.cpp,5852,424,508,bs codes,sound_cache_file_gestalt_struct_definition,,h,1433,536870912,000000001B90B740,30530496,30650616
tag_files\tag_groups.cpp,5852,664,748,bs codes,user_interface_sounds_definition_struct_definition,,h,1434,536870912,000000001B99D6C0,30531160,30651364
tag_files\tag_groups.cpp,5852,128,212,bs codes,multilingual_unicode_string_reference_block,,h,1435,536870912,000000001B983F80,30531288,30651576
tag_files\tag_groups.cpp,5852,40,124,bs codes,multilingual_unicode_string_list_language_pack_offsets,,h,1436,536870912,000000001B994E80,30531328,30651700
tag_files\tag_groups.cpp,5852,128,212,bs codes,multilingual_unicode_string_list_struct_definition,,h,1437,536870912,000000001B984760,30531456,30651912
tag_files\tag_groups.cpp,5852,120,204,bs codes,tag_template_unit_test_struct_definition,,h,1438,536870912,000000001B9843E0,30531576,30652116
tag_files\tag_groups.cpp,5852,72,156,bs codes,torque_curve_struct,,h,1439,536870912,000000001B99BB80,30531648,30652272
tag_files\tag_groups.cpp,5852,96,180,bs codes,gear_block,,h,1440,536870912,000000001B978530,30531744,30652452
tag_files\tag_groups.cpp,5852,96,180,bs codes,global_vehicle_engine_struct,,h,1441,536870912,000000001B9785F0,30531840,30652632
tag_files\tag_groups.cpp,5852,144,228,bs codes,human_tank_block,,h,1442,536870912,000000001B960EB0,30531984,30652860
tag_files\tag_groups.cpp,5852,40,124,bs codes,vehicle_steering_control_struct,,h,1443,536870912,000000001B995ED0,30532024,30652984
tag_files\tag_groups.cpp,5852,48,132,bs codes,vehicle_turning_control_struct,,h,1444,536870912,000000001B994A90,30532072,30653116
tag_files\tag_groups.cpp,5852,88,172,bs codes,human_jeep_block,,h,1445,536870912,000000001B976DF0,30532160,30653288
tag_files\tag_groups.cpp,5852,40,124,bs codes,steering_animation_struct,,h,1446,536870912,000000001B996620,30532200,30653412
tag_files\tag_groups.cpp,5852,176,260,bs codes,human_plane_block,,h,1447,536870912,000000001B98B360,30532376,30653672
tag_files\tag_groups.cpp,5852,64,148,bs codes,engine_function_struct,,h,1448,536870912,000000001B9902B0,30532440,30653820
tag_files\tag_groups.cpp,5852,216,300,bs codes,alien_scout_block,,h,1449,536870912,000000001B96A1C0,30532656,30654120
tag_files\tag_groups.cpp,5852,216,300,bs codes,alien_fighter_block,,h,1450,536870912,000000001B96B480,30532872,30654420
tag_files\tag_groups.cpp,5852,32,116,bs codes,turret_block,,h,1451,536870912,000000001B993220,30532904,30654536
tag_files\tag_groups.cpp,5852,272,356,bs codes,walker_physics_leg_block,,h,1452,536870912,000000001B982040,30533176,30654892
tag_files\tag_groups.cpp,5852,128,212,bs codes,walker_physics_struct,,h,1453,536870912,000000001B9845A0,30533304,30655104
tag_files\tag_groups.cpp,5852,280,364,bs codes,mantis_block,,h,1454,536870912,000000001B99D9C0,30533584,30655468
tag_files\tag_groups.cpp,5852,248,332,bs codes,vtol_block,,h,1455,536870912,000000001B95F660,30533832,30655800
tag_files\tag_groups.cpp,5852,184,268,bs codes,chopper_block,,h,1456,536870912,000000001B93C7C0,30534016,30656068
tag_files\tag_groups.cpp,5852,120,204,bs codes,guardian_block,,h,1457,536870912,000000001B984060,30534136,30656272
tag_files\tag_groups.cpp,5852,264,348,bs codes,vehicle_physics_types_struct,,h,1458,536870912,000000001B982320,30534400,30656620
tag_files\tag_groups.cpp,5852,168,252,bs codes,anti_gravity_point_definition_block,,h,1459,536870912,000000001B98BE00,30534568,30656872
tag_files\tag_groups.cpp,5852,160,244,bs codes,friction_point_definition_block,,h,1460,536870912,000000001B997840,30534728,30657116
tag_files\tag_groups.cpp,5852,56,140,bs codes,multisphere_sphere_storage_array,,h,1461,536870912,000000001B98EEB0,30534784,30657256
tag_files\tag_groups.cpp,5852,96,180,bs codes,multisphere_storage_array,,h,1462,536870912,000000001B977630,30534880,30657436
tag_files\tag_groups.cpp,5852,64,148,bs codes,list_shape_storage_array,,h,1463,536870912,000000001B98EAF0,30534944,30657584
tag_files\tag_groups.cpp,5852,272,356,bs codes,vehicle_phantom_shape_block,,h,1464,536870912,000000001B9828E0,30535216,30657940
tag_files\tag_groups.cpp,5852,216,300,bs codes,havok_vehicle_physics_struct,,h,1465,536870912,000000001B96A300,30535432,30658240
tag_files\tag_groups.cpp,5852,296,380,bs codes,vehicle_group,,h,1466,536870912,000000001B99DB40,30535728,30658620
tag_files\tag_groups.cpp,5852,1352,1436,bs codes,vehicle_group,,h,1467,536870912,000000001B99DCD0,30537080,30660056
tag_files\tag_groups.cpp,5852,72,156,bs codes,torque_curve_struct,,h,1468,536870912,000000001B99BE40,30537152,30660212
tag_files\tag_groups.cpp,5852,96,180,bs codes,gear_block_v1,,h,1469,536870912,000000001B9777B0,30537248,30660392
tag_files\tag_groups.cpp,5852,1608,1692,bs codes,vehicle_definition_fields_v1,,h,1470,536870912,000000001B99E280,30538856,30662084
tag_files\tag_groups.cpp,5852,40,124,bs codes,vertex_types_block,,h,1471,536870912,000000001B994850,30538896,30662208
tag_files\tag_groups.cpp,5852,48,132,bs codes,vertex_entry_point_block,,h,1472,536870912,000000001B994FA0,30538944,30662340
tag_files\tag_groups.cpp,5852,88,172,bs codes,vertex_shader_block_struct,,h,1473,536870912,000000001B977870,30539032,30662512
tag_files\tag_groups.cpp,5852,1272,1356,bs codes,gui_widget_animation_collection_definition_struct_definition,,h,1474,536870912,000000001B99E930,30540304,30663868
tag_files\tag_groups.cpp,5852,88,172,bs codes,widget_color_animation_keyframe_block,,h,1475,536870912,000000001B977930,30540392,30664040
tag_files\tag_groups.cpp,5852,72,156,bs codes,gui_widget_color_animation_definition_struct_definition,,h,1476,536870912,000000001B99B8C0,30540464,30664196
tag_files\tag_groups.cpp,5852,432,516,bs codes,melee_damage_parameters_struct,,h,1477,536870912,000000001B90C190,30540896,30664712
tag_files\tag_groups.cpp,5852,368,452,bs codes,melee_damage_parameters_fields_v2,,h,1478,536870912,000000001B99EE90,30541264,30665164
tag_files\tag_groups.cpp,5852,24,108,bs codes,melee_damage_parameters_fields_v1,,h,1479,536870912,000000001B992E20,30541288,30665272
tag_files\tag_groups.cpp,5852,104,188,bs codes,aim_assist_struct,,h,1480,536870912,000000001B989A20,30541392,30665460
tag_files\tag_groups.cpp,5852,40,124,bs codes,weapon_tracking_struct,,h,1481,536870912,000000001B9948E0,30541432,30665584
tag_files\tag_groups.cpp,5852,24,108,bs codes,weapon_tracking_fields_v1,,h,1482,536870912,000000001B992420,30541456,30665692
tag_files\tag_groups.cpp,5852,32,116,bs codes,weapon_shared_interface_struct,,h,1483,536870912,000000001B9934A0,30541488,30665808
tag_files\tag_groups.cpp,5852,88,172,bs codes,weapon_first_person_interface_block,,h,1484,536870912,000000001B9A07F0,30541576,30665980
tag_files\tag_groups.cpp,5852,96,180,bs codes,weapon_interface_struct,,h,1485,536870912,000000001B99F470,30541672,30666160
tag_files\tag_groups.cpp,5852,72,156,bs codes,magazine_objects,,h,1486,536870912,000000001B99BCE0,30541744,30666316
tag_files\tag_groups.cpp,5852,72,156,bs codes,weapon_ammunition_object_fields_v1,,h,1487,536870912,000000001B99C100,30541816,30666472
tag_files\tag_groups.cpp,5852,280,364,bs codes,magazines,,h,1488,536870912,000000001B9A1070,30542096,30666836
tag_files\tag_groups.cpp,5852,216,300,bs codes,weapon_magazine_fields_v1,,h,1489,536870912,000000001B969A40,30542312,30667136
tag_files\tag_groups.cpp,5852,56,140,bs codes,weapon_trigger_autofire_struct,,h,1490,536870912,000000001B98E7D0,30542368,30667276
tag_files\tag_groups.cpp,5852,240,324,bs codes,weapon_trigger_charging_struct,,h,1491,536870912,000000001B962930,30542608,30667600
tag_files\tag_groups.cpp,5852,136,220,bs codes,weapon_triggers,,h,1492,536870912,000000001B95FA10,30542744,30667820
tag_files\tag_groups.cpp,5852,104,188,bs codes,weapon_barrel_firing_parameters_struct,,h,1493,536870912,000000001B9896E0,30542848,30668008
tag_files\tag_groups.cpp,5852,80,164,bs codes,weapon_barrel_firing_error_struct,,h,1494,536870912,000000001B99C310,30542928,30668172
tag_files\tag_groups.cpp,5852,88,172,bs codes,weapon_barrel_dual_weapon_error_struct,,h,1495,536870912,000000001B9A0F70,30543016,30668344
tag_files\tag_groups.cpp,5852,48,132,bs codes,weapon_barrel_first_person_offset_block,,h,1496,536870912,000000001B994970,30543064,30668476
tag_files\tag_groups.cpp,5852,56,140,bs codes,weapon_barrel_damage_effect_struct,,h,1497,536870912,000000001B98F770,30543120,30668616
tag_files\tag_groups.cpp,5852,24,108,bs codes,weapon_barrel_damage_effect_fields_v1,,h,1498,536870912,000000001B993120,30543144,30668724
tag_files\tag_groups.cpp,5852,424,508,bs codes,barrel_firing_effect_block,,h,1499,536870912,000000001B90C7C0,30543568,30669232
tag_files\tag_groups.cpp,5852,240,324,bs codes,barrel_firing_effect_fields_v1,,h,1500,536870912,000000001B9A1630,30543808,30669556
tag_files\tag_groups.cpp,5852,528,612,bs codes,weapon_barrels,,h,1501,536870912,000000001B9A3200,30544336,30670168
tag_files\tag_groups.cpp,5852,512,596,bs codes,weapon_barrel_definition_fields_v2,,h,1502,536870912,000000001B9A3470,30544848,30670764
tag_files\tag_groups.cpp,5852,576,660,bs codes,weapon_barrel_definition_fields_v1,,h,1503,536870912,000000001B9A36D0,30545424,30671424
tag_files\tag_groups.cpp,5852,1240,1324,bs codes,weapon_group,,h,1504,536870912,000000001B9A3970,30546664,30672748
tag_files\tag_groups.cpp,5852,2048,2132,bs codes,weapon_group,,h,1505,536870912,000000001B9A3EB0,30548712,30674880
tag_files\tag_groups.cpp,5852,1880,1964,bs codes,weapon_fields_v3,,h,1506,536870912,000000001B9A4710,30550592,30676844
tag_files\tag_groups.cpp,5852,1032,1116,bs codes,weapon_fields_v2,,h,1507,536870912,000000001B9A4ED0,30551624,30677960
tag_files\tag_groups.cpp,5852,936,1020,bs codes,weapon_fields_v1,,h,1508,536870912,000000001B9A5340,30552560,30678980
tag_files\tag_groups.cpp,5852,72,156,bs codes,player_trait_shield_vitality_block,,h,1509,536870912,000000001B99BEF0,30552632,30679136
tag_files\tag_groups.cpp,5852,88,172,bs codes,player_trait_weapons_block,,h,1510,536870912,000000001B9A0430,30552720,30679308
tag_files\tag_groups.cpp,5852,56,140,bs codes,player_trait_movement_block,,h,1511,536870912,000000001B98FA90,30552776,30679448
tag_files\tag_groups.cpp,5852,56,140,bs codes,player_trait_appearance_block,,h,1512,536870912,000000001B98E9B0,30552832,30679588
tag_files\tag_groups.cpp,5852,40,124,bs codes,player_trait_sensors_block,,h,1513,536870912,000000001B994D60,30552872,30679712
tag_files\tag_groups.cpp,5852,152,236,bs codes,game_engine_player_traits_block,,h,1514,536870912,000000001B997C40,30553024,30679948
tag_files\tag_groups.cpp,5852,64,148,bs codes,game_engine_miscellaneous_options_block,,h,1515,536870912,000000001B9900D0,30553088,30680096
tag_files\tag_groups.cpp,5852,104,188,bs codes,game_engine_respawn_options_block,,h,1516,536870912,000000001B98A310,30553192,30680284
tag_files\tag_groups.cpp,5852,32,116,bs codes,game_engine_social_options_block,,h,1517,536870912,000000001B993520,30553224,30680400
tag_files\tag_groups.cpp,5852,112,196,bs codes,game_engine_map_override_options_block,,h,1518,536870912,000000001B98AE70,30553336,30680596
tag_files\tag_groups.cpp,5852,272,356,bs codes,game_engine_slayer_variant_block,,h,1519,536870912,000000001B9817A0,30553608,30680952
tag_files\tag_groups.cpp,5852,232,316,bs codes,game_engine_oddball_variant_block,,h,1520,536870912,000000001B9A1CC0,30553840,30681268
tag_files\tag_groups.cpp,5852,216,300,bs codes,game_engine_ctf_variant_block,,h,1521,536870912,000000001B96ABC0,30554056,30681568
tag_files\tag_groups.cpp,5852,240,324,bs codes,game_engine_assault_variant_block,,h,1522,536870912,000000001B9A2F20,30554296,30681892
tag_files\tag_groups.cpp,5852,264,348,bs codes,game_engine_infection_variant_block,,h,1523,536870912,000000001B980F00,30554560,30682240
tag_files\tag_groups.cpp,5852,216,300,bs codes,game_engine_king_variant_block,,h,1524,536870912,000000001B96A6C0,30554776,30682540
tag_files\tag_groups.cpp,5852,192,276,bs codes,game_engine_territories_variant_block,,h,1525,536870912,000000001B93C460,30554968,30682816
tag_files\tag_groups.cpp,5852,256,340,bs codes,game_engine_juggernaut_variant_block,,h,1526,536870912,000000001B95F3A0,30555224,30683156
tag_files\tag_groups.cpp,5852,280,364,bs codes,game_engine_vip_variant_block,,h,1527,536870912,000000001B9A9760,30555504,30683520
tag_files\tag_groups.cpp,5852,168,252,bs codes,game_engine_sandbox_variant_block,,h,1528,536870912,000000001B98C680,30555672,30683772
tag_files\tag_groups.cpp,5852,88,172,bs codes,game_engine_gun_game_weapon_tier_block,,h,1529,536870912,000000001B99F230,30555760,30683944
tag_files\tag_groups.cpp,5852,344,428,bs codes,game_engine_gun_game_variant_block,,h,1530,536870912,000000001B9A98E0,30556104,30684372
tag_files\tag_groups.cpp,5852,136,220,bs codes,game_engine_campaign_variant_block,,h,1531,536870912,000000001B961090,30556240,30684592
tag_files\tag_groups.cpp,5852,344,428,bs codes,game_engine_settings_definition_struct_definition,,h,1532,536870912,000000001B9A9AA0,30556584,30685020
tag_files\tag_groups.cpp,5852,72,156,bs codes,widget_font_animation_keyframe_block,,h,1533,536870912,000000001B99C7E0,30556656,30685176
tag_files\tag_groups.cpp,5852,72,156,bs codes,gui_widget_font_animation_definition_struct_definition,,h,1534,536870912,000000001B99C9F0,30556728,30685332
tag_files\tag_groups.cpp,5852,264,348,bs codes,gui_widget_animation_definition_struct_definition,,h,1535,536870912,000000001B981070,30556992,30685680
tag_files\tag_groups.cpp,5852,56,140,bs codes,gui_widget_reference_block,,h,1536,536870912,000000001B98ECD0,30557048,30685820
tag_files\tag_groups.cpp,5852,144,228,bs codes,user_interface_globals_definition_struct_definition,,h,1537,536870912,000000001B960DC0,30557192,30686048
tag_files\tag_groups.cpp,5852,168,252,bs codes,states_block,,h,1538,536870912,000000001B98CAC0,30557360,30686300
tag_files\tag_groups.cpp,5852,88,172,bs codes,rules_block,,h,1539,536870912,000000001B99F770,30557448,30686472
tag_files\tag_groups.cpp,5852,336,420,bs codes,cellular_automata2d_struct_definition,,h,1540,536870912,000000001B9A9C60,30557784,30686892
tag_files\tag_groups.cpp,5852,64,148,bs codes,color_presets_block,,h,1541,536870912,000000001B98FC70,30557848,30687040
tag_files\tag_groups.cpp,5852,56,140,bs codes,color_list_block,,h,1542,536870912,000000001B98F8B0,30557904,30687180
tag_files\tag_groups.cpp,5852,120,204,bs codes,tint_colors_block,,h,1543,536870912,000000001B983960,30558024,30687384
tag_files\tag_groups.cpp,5852,80,164,bs codes,gui_alert_description_block,,h,1544,536870912,000000001B99B130,30558104,30687548
tag_files\tag_groups.cpp,5852,120,204,bs codes,gui_dialog_description_block,,h,1545,536870912,000000001B9830A0,30558224,30687752
tag_files\tag_groups.cpp,5852,544,628,bs codes,user_interface_shared_globals_definition_struct_definition,,h,1546,536870912,000000001B9A9E10,30558768,30688380
tag_files\tag_groups.cpp,5852,40,124,bs codes,wind_scalar_function_struct,,h,1547,536870912,000000001B995660,30558808,30688504
tag_files\tag_groups.cpp,5852,144,228,bs codes,wind_block,,h,1548,536870912,000000001B960FA0,30558952,30688732
tag_files\tag_groups.cpp,5852,80,164,bs codes,widget_position_animation_keyframe_block,,h,1549,536870912,000000001B99BC30,30559032,30688896
tag_files\tag_groups.cpp,5852,72,156,bs codes,gui_widget_position_animation_definition_struct_definition,,h,1550,536870912,000000001B99BFA0,30559104,30689052
tag_files\tag_groups.cpp,5852,96,180,bs codes,widget_rotation_animation_keyframe_block,,h,1551,536870912,000000001B9A0AF0,30559200,30689232
tag_files\tag_groups.cpp,5852,72,156,bs codes,gui_widget_rotation_animation_definition_struct_definition,,h,1552,536870912,000000001B99C890,30559272,30689388
tag_files\tag_groups.cpp,5852,104,188,bs codes,widget_scale_animation_keyframe_block,,h,1553,536870912,000000001B989880,30559376,30689576
tag_files\tag_groups.cpp,5852,72,156,bs codes,gui_widget_scale_animation_definition_struct_definition,,h,1554,536870912,000000001B99C940,30559448,30689732
tag_files\tag_groups.cpp,5852,72,156,bs codes,widget_sprite_animation_keyframe_block,,h,1555,536870912,000000001B99CF70,30559520,30689888
tag_files\tag_groups.cpp,5852,72,156,bs codes,gui_widget_sprite_animation_definition_struct_definition,,h,1556,536870912,000000001B99C3C0,30559592,30690044
tag_files\tag_groups.cpp,5852,72,156,bs codes,widget_texture_coordinate_animation_keyframe_block,,h,1557,536870912,000000001B99B810,30559664,30690200
tag_files\tag_groups.cpp,5852,72,156,bs codes,gui_widget_texture_coordinate_animation_definition_struct_definition,,h,1558,536870912,000000001B99CC00,30559736,30690356
tag_files\tag_groups.cpp,5852,64,148,bs codes,cache_file_interop_type_identifier_block,,h,1559,536870912,000000001B990170,30559800,30690504
tag_files\tag_groups.cpp,5852,40,124,bs codes,cache_file_resource_fixup_location_block,,h,1560,536870912,000000001B995420,30559840,30690628
tag_files\tag_groups.cpp,5852,40,124,bs codes,cache_file_resource_interop_location_block,,h,1561,536870912,000000001B995A50,30559880,30690752
tag_files\tag_groups.cpp,5852,176,260,bs codes,cache_file_resource_data_block,,h,1562,536870912,000000001B98C350,30560056,30691012
tag_files\tag_groups.cpp,5852,32,116,bs codes,cache_file_tag_resources_bitvector_block,,h,1563,536870912,000000001B9935A0,30560088,30691128
tag_files\tag_groups.cpp,5852,64,148,bs codes,cache_file_tag_resource_usage_block_struct,,h,1564,536870912,000000001B990210,30560152,30691276
tag_files\tag_groups.cpp,5852,32,116,bs codes,cache_file_zone_resource_visit_node_link_block,,h,1565,536870912,000000001B992120,30560184,30691392
tag_files\tag_groups.cpp,5852,64,148,bs codes,cache_file_zone_resource_visit_node_block_struct,,h,1566,536870912,000000001B990350,30560248,30691540
tag_files\tag_groups.cpp,5852,264,348,bs codes,cache_file_tag_zone_manifest_struct,,h,1567,536870912,000000001B980AB0,30560512,30691888
tag_files\tag_groups.cpp,5852,96,180,bs codes,cache_file_zone_set_zone_usage_block,,h,1568,536870912,000000001B99F3B0,30560608,30692068
tag_files\tag_groups.cpp,5852,56,140,bs codes,cache_file_bsp_reference_block,,h,1569,536870912,000000001B9903F0,30560664,30692208
tag_files\tag_groups.cpp,5852,56,140,bs codes,cache_file_resource_owner_block,,h,1570,536870912,000000001B98EFF0,30560720,30692348
tag_files\tag_groups.cpp,5852,32,116,bs codes,cache_file_resource_owner_reference_block,,h,1571,536870912,000000001B993820,30560752,30692464
tag_files\tag_groups.cpp,5852,72,156,bs codes,cache_file_model_variant_usage_block,,h,1572,536870912,000000001B99C5D0,30560824,30692620
tag_files\tag_groups.cpp,5852,32,116,bs codes,cache_file_model_variant_usage_reference_block,,h,1573,536870912,000000001B993620,30560856,30692736
tag_files\tag_groups.cpp,5852,64,148,bs codes,cache_file_character_usage_block,,h,1574,536870912,000000001B98E910,30560920,30692884
tag_files\tag_groups.cpp,5852,56,140,bs codes,cache_file_bsp_attachment_block,,h,1575,536870912,000000001B98F090,30560976,30693024
tag_files\tag_groups.cpp,5852,96,180,bs codes,cache_file_bsp_game_attachments_block_struct,,h,1576,536870912,000000001B99F2F0,30561072,30693204
tag_files\tag_groups.cpp,5852,88,172,bs codes,debug_cache_file_zone_manifest_struct,,h,1577,536870912,000000001B99FEF0,30561160,30693376
tag_files\tag_groups.cpp,5852,32,116,bs codes,resource_category_block,,h,1578,536870912,000000001B992EA0,30561192,30693492
tag_files\tag_groups.cpp,5852,48,132,bs codes,cache_file_debug_resource_definition_block,,h,1579,536870912,000000001B995930,30561240,30693624
tag_files\tag_groups.cpp,5852,104,188,bs codes,cache_file_resource_layout_block_struct,,h,1580,536870912,000000001B989F00,30561344,30693812
tag_files\tag_groups.cpp,5852,64,148,bs codes,cache_file_tag_resource_named_value_block,,h,1581,536870912,000000001B98F3B0,30561408,30693960
tag_files\tag_groups.cpp,5852,48,132,bs codes,cache_file_tag_resource_properties_block,,h,1582,536870912,000000001B994BB0,30561456,30694092
tag_files\tag_groups.cpp,5852,32,116,bs codes,cache_file_tag_parentage_reference_block,,h,1583,536870912,000000001B993AA0,30561488,30694208
tag_files\tag_groups.cpp,5852,120,204,bs codes,cache_file_tag_parentage_block_struct,,h,1584,536870912,000000001B984840,30561608,30694412
tag_files\tag_groups.cpp,5852,32,116,bs codes,cache_file_tag_resource_prediction_quantum_block,,h,1585,536870912,000000001B991F20,30561640,30694528
tag_files\tag_groups.cpp,5852,48,132,bs codes,cache_file_tag_resource_prediction_atom_block,,h,1586,536870912,000000001B995AE0,30561688,30694660
tag_files\tag_groups.cpp,5852,32,116,bs codes,cache_file_tag_resource_prediction_molecule_atom_reference_block,,h,1587,536870912,000000001B992B20,30561720,30694776
tag_files\tag_groups.cpp,5852,56,140,bs codes,cache_file_tag_resource_prediction_molecule_block,,h,1588,536870912,000000001B98FE50,30561776,30694916
tag_files\tag_groups.cpp,5852,48,132,bs codes,cache_file_tag_resource_prediction_molecule_keys_block,,h,1589,536870912,000000001B994A00,30561824,30695048
tag_files\tag_groups.cpp,5852,144,228,bs codes,cache_file_tag_resource_prediction_table,,h,1590,536870912,000000001B961180,30561968,30695276
tag_files\tag_groups.cpp,5852,1008,1092,bs codes,cache_file_resource_gestalt_block_struct,,h,1591,536870912,000000001B9AA090,30562976,30696368
tag_files\tag_groups.cpp,5852,64,148,bs codes,asset_depot_storage_stream,,h,1592,536870912,000000001B98EA50,30563040,30696516
tag_files\tag_groups.cpp,5852,112,196,bs codes,tag_import_file_block,,h,1593,536870912,000000001B98A720,30563152,30696712
tag_files\tag_groups.cpp,5852,72,156,bs codes,tag_import_event_block,,h,1594,536870912,000000001B99CAA0,30563224,30696868
tag_files\tag_groups.cpp,5852,128,212,bs codes,not_global_tag_import_info_block,,h,1595,536870912,000000001B983500,30563352,30697080
tag_files\tag_groups.cpp,5852,64,148,bs codes,tag_dependency_block_definition,,h,1596,536870912,000000001B98EB90,30563416,30697228
tag_files\tag_groups.cpp,5852,48,132,bs codes,tag_dependency_list_stream,,h,1597,536870912,000000001B994F10,30563464,30697360
tag_files\tag_groups.cpp,649,2101280,2101364,data,,tag instance,h,1598,536870912,0000000024A5C040,32664744,32798724
tag_files\tag_groups.cpp,695,104,188,constant pool,,tag names,h,1600,536870912,000000001B989FD0,32664848,32798912
memory\constant_pool.cpp,76,2883584,2883668,hash_table,,tag names,h,1601,536870912,0000000024DD1040,35548432,35682580
tag_files\tag_groups.cpp,695,1056832,1056916,data,,tag names,h,1602,536870912,00000000250A4040,36605264,36739496
tag_files\tag_groups.cpp,695,8355681,8355765,memory_pool,constant pool,pool,h,1603,536870912,00000000251BD040,44960945,45095261
tag_files\tag_group_stream_runtime.cpp,157,266328,266412,data,,tag stream headers,h,1604,536870912,00000000259C0080,45227273,45361673
tag_files\tag_group_stream_runtime.cpp,68,1581128,1581212,data,,tag streams,h,1605,536870912,0000000025BCA040,46808401,46942885
tag_files\tag_resource_runtime.cpp,55,69726,69810,data,,tag resource owners,h,1606,536870912,000000001B9AA4E0,46878127,47012695
tag_files\single_tag_file_backend.cpp,1425,32559,32643,single tag file backend,,,h,1607,536870912,000000001B9BB5A0,46910686,47045338
